fecha;siglas;grupo_edad;hombres;mujeres;enfermos
2020-10-19;AV;0-9;271;234;505
2020-10-19;PA;0-9;247;225;472
2020-10-19;SO;0-9;157;151;308
2020-10-19;ZA;0-9;296;278;574
2020-10-19;BU;10-19;889;779;1668
2020-10-19;ZA;10-19;207;198;405
2020-10-19;LE;20-29;929;1085;2014
2020-10-19;PA;20-29;426;445;871
2020-10-19;SA;20-29;1103;1307;2410
2020-10-19;AV;30-39;448;599;1047
2020-10-19;BU;30-39;1372;1636;3008
2020-10-19;SE;30-39;616;791;1407
2020-10-19;SO;30-39;314;422;736
2020-10-19;VA;30-39;1585;2039;3624
2020-10-19;LE;40-49;1526;2169;3695
2020-10-19;SO;40-49;442;622;1064
2020-10-19;CyL;40-49;9712;12809;22521
2020-10-19;AV;50-59;590;888;1478
2020-10-19;LE;60-69;1275;1477;2752
2020-10-19;PA;60-69;537;555;1092
2020-10-19;SA;60-69;1197;1328;2525
2020-10-19;SO;60-69;360;419;779
2020-10-19;LE;70-79;962;931;1893
2020-10-19;PA;70-79;379;366;745
2020-10-19;SE;70-79;527;526;1053
2020-10-19;VA;70-79;1033;1112;2145
2020-10-19;SE;>80;732;1208;1940
2020-10-19;BU;0-9;839;725;1564
2020-10-19;SA;0-9;681;666;1347
2020-10-19;SE;0-9;437;412;849
2020-10-19;VA;0-9;1129;971;2100
2020-10-19;LE;10-19;747;693;1440
2020-10-19;SA;10-19;754;844;1598
2020-10-19;SE;10-19;414;360;774
2020-10-19;SO;10-19;173;156;329
2020-10-19;SO;20-29;268;331;599
2020-10-19;VA;20-29;1358;1555;2913
2020-10-19;ZA;20-29;216;259;475
2020-10-19;LE;30-39;1066;1591;2657
2020-10-19;SA;30-39;1149;1552;2701
2020-10-19;ZA;30-39;273;388;661
2020-10-19;AV;40-49;646;820;1466
2020-10-19;BU;40-49;1751;2053;3804
2020-10-19;PA;40-49;641;774;1415
2020-10-19;SE;40-49;849;1171;2020
2020-10-19;LE;50-59;1477;2110;3587
2020-10-19;PA;50-59;653;824;1477
2020-10-19;SA;50-59;1567;2212;3779
2020-10-19;SE;50-59;974;1444;2418
2020-10-19;ZA;50-59;453;638;1091
2020-10-19;CyL;50-59;9457;13331;22788
2020-10-19;SE;60-69;818;874;1692
2020-10-19;ZA;60-69;398;423;821
2020-10-19;CyL;60-69;7570;8544;16114
2020-10-19;BU;70-79;707;718;1425
2020-10-19;SA;70-79;829;904;1733
2020-10-19;CyL;70-79;5361;5492;10853
2020-10-19;LE;>80;1128;2051;3179
2020-10-19;PA;>80;368;663;1031
2020-10-19;SA;>80;1075;1963;3038
2020-10-19;ZA;>80;377;623;1000
2020-10-19;CyL;>80;6469;11694;18163
2020-10-19;LE;0-9;620;562;1182
2020-10-19;CyL;0-9;4677;4224;8901
2020-10-19;AV;10-19;261;252;513
2020-10-19;PA;10-19;325;330;655
2020-10-19;VA;10-19;1023;1027;2050
2020-10-19;CyL;10-19;4793;4639;9432
2020-10-19;AV;20-29;331;392;723
2020-10-19;BU;20-29;1151;1291;2442
2020-10-19;SE;20-29;489;602;1091
2020-10-19;CyL;20-29;6271;7267;13538
2020-10-19;PA;30-39;477;584;1061
2020-10-19;CyL;30-39;7300;9602;16902
2020-10-19;SA;40-49;1390;1850;3240
2020-10-19;VA;40-49;2082;2801;4883
2020-10-19;ZA;40-49;385;549;934
2020-10-19;BU;50-59;1499;2035;3534
2020-10-19;SO;50-59;475;720;1195
2020-10-19;VA;50-59;1769;2460;4229
2020-10-19;AV;60-69;544;612;1156
2020-10-19;BU;60-69;1058;1187;2245
2020-10-19;VA;60-69;1383;1669;3052
2020-10-19;AV;70-79;397;434;831
2020-10-19;SO;70-79;248;226;474
2020-10-19;ZA;70-79;279;275;554
2020-10-19;AV;>80;510;863;1373
2020-10-19;BU;>80;814;1487;2301
2020-10-19;SO;>80;451;814;1265
2020-10-19;VA;>80;1014;2022;3036
2020-10-18;AV;0-9;268;230;498
2020-10-18;BU;0-9;832;714;1546
2020-10-18;PA;0-9;243;223;466
2020-10-18;AV;10-19;260;244;504
2020-10-18;BU;10-19;884;764;1648
2020-10-18;SE;10-19;396;354;750
2020-10-18;ZA;10-19;204;194;398
2020-10-18;AV;20-29;323;389;712
2020-10-18;LE;20-29;926;1078;2004
2020-10-18;SO;20-29;267;331;598
2020-10-18;VA;20-29;1339;1530;2869
2020-10-18;ZA;20-29;216;256;472
2020-10-18;AV;30-39;444;594;1038
2020-10-18;SA;30-39;1133;1525;2658
2020-10-18;SO;30-39;311;419;730
2020-10-18;ZA;30-39;274;384;658
2020-10-18;VA;40-49;2054;2779;4833
2020-10-18;ZA;40-49;382;546;928
2020-10-18;AV;50-59;586;885;1471
2020-10-18;LE;50-59;1461;2093;3554
2020-10-18;PA;50-59;643;803;1446
2020-10-18;SA;50-59;1553;2195;3748
2020-10-18;ZA;50-59;452;632;1084
2020-10-18;CyL;50-59;9371;13207;22578
2020-10-18;VA;60-69;1367;1648;3015
2020-10-18;ZA;60-69;395;421;816
2020-10-18;CyL;60-69;7496;8467;15963
2020-10-18;VA;70-79;1019;1096;2115
2020-10-18;SA;>80;1068;1950;3018
2020-10-18;VA;>80;1008;2010;3018
2020-10-18;LE;0-9;618;561;1179
2020-10-18;SA;0-9;673;661;1334
2020-10-18;SE;0-9;431;407;838
2020-10-18;SO;0-9;159;149;308
2020-10-18;ZA;0-9;296;278;574
2020-10-18;CyL;0-9;4637;4183;8820
2020-10-18;LE;10-19;741;680;1421
2020-10-18;PA;10-19;323;325;648
2020-10-18;SA;10-19;724;784;1508
2020-10-18;CyL;10-19;4702;4506;9208
2020-10-18;BU;20-29;1133;1273;2406
2020-10-18;PA;20-29;425;441;866
2020-10-18;SE;20-29;479;602;1081
2020-10-18;CyL;20-29;6187;7175;13362
2020-10-18;LE;30-39;1052;1580;2632
2020-10-18;PA;30-39;472;576;1048
2020-10-18;SE;30-39;609;789;1398
2020-10-18;VA;30-39;1568;2017;3585
2020-10-18;BU;40-49;1737;2028;3765
2020-10-18;PA;40-49;638;765;1403
2020-10-18;SO;40-49;441;621;1062
2020-10-18;CyL;40-49;9623;12702;22325
2020-10-18;SE;50-59;969;1439;2408
2020-10-18;BU;60-69;1045;1174;2219
2020-10-18;SE;60-69;815;868;1683
2020-10-18;LE;70-79;957;925;1882
2020-10-18;PA;70-79;373;362;735
2020-10-18;SE;70-79;526;526;1052
2020-10-18;BU;>80;811;1481;2292
2020-10-18;LE;>80;1120;2044;3164
2020-10-18;SE;>80;730;1208;1938
2020-10-18;VA;0-9;1117;960;2077
2020-10-18;SO;10-19;170;153;323
2020-10-18;VA;10-19;1000;1008;2008
2020-10-18;SA;20-29;1079;1275;2354
2020-10-18;BU;30-39;1355;1609;2964
2020-10-18;CyL;30-39;7218;9493;16711
2020-10-18;AV;40-49;638;818;1456
2020-10-18;LE;40-49;1510;2151;3661
2020-10-18;SA;40-49;1377;1831;3208
2020-10-18;SE;40-49;846;1163;2009
2020-10-18;BU;50-59;1486;2016;3502
2020-10-18;SO;50-59;474;717;1191
2020-10-18;VA;50-59;1747;2427;4174
2020-10-18;AV;60-69;542;610;1152
2020-10-18;LE;60-69;1261;1462;2723
2020-10-18;PA;60-69;529;546;1075
2020-10-18;SA;60-69;1185;1320;2505
2020-10-18;SO;60-69;357;418;775
2020-10-18;AV;70-79;395;433;828
2020-10-18;BU;70-79;705;715;1420
2020-10-18;SA;70-79;829;900;1729
2020-10-18;SO;70-79;248;225;473
2020-10-18;ZA;70-79;277;274;551
2020-10-18;CyL;70-79;5329;5456;10785
2020-10-18;AV;>80;509;862;1371
2020-10-18;PA;>80;364;631;995
2020-10-18;SO;>80;451;808;1259
2020-10-18;ZA;>80;375;618;993
2020-10-18;CyL;>80;6436;11612;18048
2020-10-15;AV;0-9;263;229;492
2020-10-15;CyL;0-9;4542;4092;8634
2020-10-15;PA;10-19;305;300;605
2020-10-15;SE;10-19;376;346;722
2020-10-15;SO;10-19;161;146;307
2020-10-15;ZA;10-19;192;182;374
2020-10-15;CyL;10-19;4532;4304;8836
2020-10-15;AV;20-29;319;384;703
2020-10-15;BU;20-29;1096;1240;2336
2020-10-15;PA;20-29;413;424;837
2020-10-15;SE;20-29;463;592;1055
2020-10-15;LE;30-39;1019;1530;2549
2020-10-15;SA;30-39;1108;1500;2608
2020-10-15;LE;40-49;1452;2093;3545
2020-10-15;SE;40-49;831;1149;1980
2020-10-15;SO;40-49;435;613;1048
2020-10-15;LE;50-59;1402;2030;3432
2020-10-15;ZA;50-59;429;613;1042
2020-10-15;CyL;50-59;9128;12944;22072
2020-10-15;SE;60-69;808;864;1672
2020-10-15;SO;60-69;344;413;757
2020-10-15;VA;60-69;1324;1616;2940
2020-10-15;SO;70-79;240;219;459
2020-10-15;VA;70-79;999;1080;2079
2020-10-15;AV;>80;507;858;1365
2020-10-15;LE;>80;1074;2004;3078
2020-10-15;PA;>80;348;623;971
2020-10-15;SA;>80;1053;1919;2972
2020-10-15;SE;>80;728;1200;1928
2020-10-15;PA;0-9;234;213;447
2020-10-15;SE;0-9;426;400;826
2020-10-15;SO;0-9;159;145;304
2020-10-15;VA;0-9;1098;947;2045
2020-10-15;BU;10-19;859;739;1598
2020-10-15;VA;10-19;989;979;1968
2020-10-15;SA;20-29;1034;1224;2258
2020-10-15;SO;20-29;258;325;583
2020-10-15;VA;20-29;1310;1496;2806
2020-10-15;CyL;20-29;5992;6970;12962
2020-10-15;SE;30-39;595;774;1369
2020-10-15;VA;30-39;1550;1991;3541
2020-10-15;CyL;30-39;7058;9302;16360
2020-10-15;AV;40-49;626;811;1437
2020-10-15;PA;40-49;626;745;1371
2020-10-15;ZA;40-49;362;530;892
2020-10-15;CyL;40-49;9406;12472;21878
2020-10-15;PA;50-59;614;773;1387
2020-10-15;AV;70-79;388;429;817
2020-10-15;BU;70-79;681;695;1376
2020-10-15;LE;70-79;930;885;1815
2020-10-15;PA;70-79;353;350;703
2020-10-15;SA;70-79;811;881;1692
2020-10-15;SE;70-79;523;524;1047
2020-10-15;CyL;70-79;5199;5330;10529
2020-10-15;BU;0-9;810;698;1508
2020-10-15;LE;0-9;597;540;1137
2020-10-15;SA;0-9;666;645;1311
2020-10-15;ZA;0-9;289;275;564
2020-10-15;AV;10-19;254;237;491
2020-10-15;LE;10-19;697;648;1345
2020-10-15;SA;10-19;699;727;1426
2020-10-15;LE;20-29;891;1038;1929
2020-10-15;ZA;20-29;208;247;455
2020-10-15;AV;30-39;437;586;1023
2020-10-15;BU;30-39;1318;1576;2894
2020-10-15;PA;30-39;454;556;1010
2020-10-15;SO;30-39;308;416;724
2020-10-15;ZA;30-39;269;373;642
2020-10-15;BU;40-49;1691;1982;3673
2020-10-15;SA;40-49;1363;1807;3170
2020-10-15;VA;40-49;2020;2742;4762
2020-10-15;AV;50-59;580;876;1456
2020-10-15;BU;50-59;1452;1974;3426
2020-10-15;SA;50-59;1512;2160;3672
2020-10-15;SE;50-59;954;1424;2378
2020-10-15;SO;50-59;461;705;1166
2020-10-15;VA;50-59;1724;2389;4113
2020-10-15;AV;60-69;537;608;1145
2020-10-15;BU;60-69;1025;1142;2167
2020-10-15;LE;60-69;1211;1417;2628
2020-10-15;PA;60-69;506;533;1039
2020-10-15;SA;60-69;1160;1308;2468
2020-10-15;ZA;60-69;381;409;790
2020-10-15;CyL;60-69;7296;8310;15606
2020-10-15;ZA;70-79;274;267;541
2020-10-15;BU;>80;802;1433;2235
2020-10-15;SO;>80;448;796;1244
2020-10-15;VA;>80;993;1984;2977
2020-10-15;ZA;>80;362;601;963
2020-10-15;CyL;>80;6315;11418;17733
2020-10-14;AV;0-9;261;228;489
2020-10-14;BU;0-9;806;689;1495
2020-10-14;LE;0-9;598;531;1129
2020-10-14;PA;0-9;231;206;437
2020-10-14;BU;10-19;840;725;1565
2020-10-14;LE;10-19;676;623;1299
2020-10-14;SO;10-19;159;143;302
2020-10-14;CyL;10-19;4429;4198;8627
2020-10-14;PA;20-29;409;420;829
2020-10-14;SA;20-29;998;1193;2191
2020-10-14;CyL;20-29;5878;6872;12750
2020-10-14;PA;30-39;450;551;1001
2020-10-14;SA;30-39;1095;1485;2580
2020-10-14;CyL;30-39;6986;9203;16189
2020-10-14;LE;40-49;1433;2059;3492
2020-10-14;SA;40-49;1342;1789;3131
2020-10-14;SE;40-49;825;1141;1966
2020-10-14;AV;50-59;579;876;1455
2020-10-14;SO;50-59;457;698;1155
2020-10-14;SO;60-69;342;410;752
2020-10-14;CyL;60-69;7224;8239;15463
2020-10-14;AV;70-79;388;425;813
2020-10-14;LE;70-79;919;872;1791
2020-10-14;SE;70-79;523;522;1045
2020-10-14;AV;>80;505;858;1363
2020-10-14;SA;0-9;661;641;1302
2020-10-14;SE;0-9;427;399;826
2020-10-14;VA;0-9;1092;933;2025
2020-10-14;ZA;0-9;289;273;562
2020-10-14;CyL;0-9;4525;4046;8571
2020-10-14;PA;10-19;297;291;588
2020-10-14;SA;10-19;673;695;1368
2020-10-14;SE;20-29;455;588;1043
2020-10-14;SO;20-29;255;324;579
2020-10-14;BU;30-39;1295;1550;2845
2020-10-14;BU;40-49;1665;1959;3624
2020-10-14;PA;40-49;618;733;1351
2020-10-14;VA;40-49;1999;2717;4716
2020-10-14;ZA;40-49;355;527;882
2020-10-14;CyL;50-59;9011;12816;21827
2020-10-14;BU;60-69;1019;1128;2147
2020-10-14;LE;60-69;1183;1396;2579
2020-10-14;SE;60-69;807;863;1670
2020-10-14;ZA;60-69;373;405;778
2020-10-14;BU;70-79;669;684;1353
2020-10-14;PA;70-79;346;346;692
2020-10-14;VA;70-79;987;1069;2056
2020-10-14;CyL;70-79;5136;5272;10408
2020-10-14;SO;>80;445;792;1237
2020-10-14;VA;>80;988;1982;2970
2020-10-14;SO;0-9;160;146;306
2020-10-14;AV;10-19;254;237;491
2020-10-14;SE;10-19;368;334;702
2020-10-14;VA;10-19;975;969;1944
2020-10-14;ZA;10-19;187;181;368
2020-10-14;AV;20-29;316;383;699
2020-10-14;BU;20-29;1077;1223;2300
2020-10-14;LE;20-29;868;1016;1884
2020-10-14;VA;20-29;1294;1480;2774
2020-10-14;ZA;20-29;206;245;451
2020-10-14;AV;30-39;435;582;1017
2020-10-14;LE;30-39;1010;1506;2516
2020-10-14;SE;30-39;591;768;1359
2020-10-14;SO;30-39;306;416;722
2020-10-14;VA;30-39;1539;1982;3521
2020-10-14;ZA;30-39;265;363;628
2020-10-14;AV;40-49;625;811;1436
2020-10-14;SO;40-49;433;611;1044
2020-10-14;CyL;40-49;9295;12347;21642
2020-10-14;BU;50-59;1433;1956;3389
2020-10-14;LE;50-59;1371;1987;3358
2020-10-14;PA;50-59;603;766;1369
2020-10-14;SA;50-59;1495;2136;3631
2020-10-14;SE;50-59;954;1418;2372
2020-10-14;VA;50-59;1698;2374;4072
2020-10-14;ZA;50-59;421;605;1026
2020-10-14;AV;60-69;534;606;1140
2020-10-14;PA;60-69;501;530;1031
2020-10-14;SA;60-69;1154;1293;2447
2020-10-14;VA;60-69;1311;1608;2919
2020-10-14;SA;70-79;798;875;1673
2020-10-14;SO;70-79;238;217;455
2020-10-14;ZA;70-79;268;262;530
2020-10-14;BU;>80;791;1427;2218
2020-10-14;LE;>80;1061;1984;3045
2020-10-14;PA;>80;343;621;964
2020-10-14;SA;>80;1045;1912;2957
2020-10-14;SE;>80;728;1200;1928
2020-10-14;ZA;>80;358;600;958
2020-10-14;CyL;>80;6264;11376;17640
2020-10-13;BU;0-9;796;675;1471
2020-10-13;SO;0-9;159;144;303
2020-10-13;VA;0-9;1082;916;1998
2020-10-13;CyL;0-9;4479;3990;8469
2020-10-13;BU;10-19;821;713;1534
2020-10-13;SA;10-19;658;675;1333
2020-10-13;SO;10-19;156;143;299
2020-10-13;ZA;10-19;182;178;360
2020-10-13;CyL;10-19;4344;4110;8454
2020-10-13;SE;20-29;455;581;1036
2020-10-13;BU;30-39;1271;1539;2810
2020-10-13;LE;30-39;994;1493;2487
2020-10-13;SO;30-39;306;414;720
2020-10-13;CyL;30-39;6907;9129;16036
2020-10-13;BU;40-49;1650;1936;3586
2020-10-13;LE;40-49;1424;2044;3468
2020-10-13;SA;50-59;1485;2121;3606
2020-10-13;VA;50-59;1681;2336;4017
2020-10-13;ZA;50-59;417;602;1019
2020-10-13;CyL;50-59;8919;12700;21619
2020-10-13;AV;60-69;530;602;1132
2020-10-13;PA;60-69;492;523;1015
2020-10-13;SE;60-69;804;860;1664
2020-10-13;LE;70-79;913;861;1774
2020-10-13;SO;70-79;237;217;454
2020-10-13;BU;>80;779;1414;2193
2020-10-13;LE;>80;1050;1967;3017
2020-10-13;PA;>80;331;606;937
2020-10-13;SE;>80;726;1195;1921
2020-10-13;VA;>80;982;1967;2949
2020-10-13;ZA;>80;355;599;954
2020-10-13;LE;0-9;594;524;1118
2020-10-13;SA;0-9;659;638;1297
2020-10-13;SE;0-9;421;393;814
2020-10-13;ZA;0-9;286;271;557
2020-10-13;AV;10-19;248;235;483
2020-10-13;PA;10-19;291;280;571
2020-10-13;SE;10-19;368;326;694
2020-10-13;VA;10-19;961;948;1909
2020-10-13;BU;20-29;1057;1211;2268
2020-10-13;PA;20-29;408;412;820
2020-10-13;SA;20-29;975;1175;2150
2020-10-13;ZA;20-29;198;241;439
2020-10-13;AV;30-39;429;579;1008
2020-10-13;PA;30-39;446;538;984
2020-10-13;SA;30-39;1086;1475;2561
2020-10-13;AV;40-49;622;805;1427
2020-10-13;SE;40-49;820;1133;1953
2020-10-13;SO;40-49;433;609;1042
2020-10-13;SE;50-59;949;1408;2357
2020-10-13;SO;50-59;456;698;1154
2020-10-13;LE;60-69;1171;1380;2551
2020-10-13;SO;60-69;341;410;751
2020-10-13;VA;60-69;1297;1592;2889
2020-10-13;ZA;60-69;367;402;769
2020-10-13;CyL;60-69;7160;8167;15327
2020-10-13;AV;70-79;386;425;811
2020-10-13;BU;70-79;660;682;1342
2020-10-13;SA;70-79;794;865;1659
2020-10-13;SE;70-79;520;520;1040
2020-10-13;AV;>80;502;855;1357
2020-10-13;SO;>80;445;791;1236
2020-10-13;AV;0-9;255;227;482
2020-10-13;PA;0-9;227;202;429
2020-10-13;LE;10-19;659;612;1271
2020-10-13;AV;20-29;314;383;697
2020-10-13;LE;20-29;861;1007;1868
2020-10-13;SO;20-29;255;324;579
2020-10-13;VA;20-29;1272;1463;2735
2020-10-13;CyL;20-29;5795;6797;12592
2020-10-13;SE;30-39;590;766;1356
2020-10-13;VA;30-39;1522;1965;3487
2020-10-13;ZA;30-39;263;360;623
2020-10-13;PA;40-49;612;722;1334
2020-10-13;SA;40-49;1333;1783;3116
2020-10-13;VA;40-49;1982;2695;4677
2020-10-13;ZA;40-49;351;522;873
2020-10-13;CyL;40-49;9227;12249;21476
2020-10-13;AV;50-59;574;876;1450
2020-10-13;BU;50-59;1402;1932;3334
2020-10-13;LE;50-59;1355;1968;3323
2020-10-13;PA;50-59;600;759;1359
2020-10-13;BU;60-69;1008;1116;2124
2020-10-13;SA;60-69;1150;1282;2432
2020-10-13;PA;70-79;343;345;688
2020-10-13;VA;70-79;979;1057;2036
2020-10-13;ZA;70-79;267;259;526
2020-10-13;CyL;70-79;5099;5231;10330
2020-10-13;SA;>80;1042;1902;2944
2020-10-13;CyL;>80;6212;11296;17508
2020-10-12;SO;0-9;159;143;302
2020-10-12;ZA;0-9;282;270;552
2020-10-12;CyL;0-9;4455;3958;8413
2020-10-12;AV;10-19;243;233;476
2020-10-12;BU;10-19;809;707;1516
2020-10-12;LE;10-19;649;606;1255
2020-10-12;SA;10-19;646;648;1294
2020-10-12;SE;10-19;358;323;681
2020-10-12;VA;10-19;948;936;1884
2020-10-12;ZA;10-19;180;177;357
2020-10-12;LE;20-29;847;996;1843
2020-10-12;PA;20-29;402;402;804
2020-10-12;SO;20-29;254;323;577
2020-10-12;VA;20-29;1261;1452;2713
2020-10-12;ZA;20-29;198;238;436
2020-10-12;BU;30-39;1262;1529;2791
2020-10-12;SE;30-39;585;762;1347
2020-10-12;CyL;30-39;6852;9064;15916
2020-10-12;SA;40-49;1322;1771;3093
2020-10-12;SO;40-49;431;608;1039
2020-10-12;VA;40-49;1960;2676;4636
2020-10-12;SO;50-59;452;698;1150
2020-10-12;AV;60-69;529;599;1128
2020-10-12;SE;60-69;798;852;1650
2020-10-12;VA;60-69;1291;1578;2869
2020-10-12;AV;70-79;385;425;810
2020-10-12;SA;70-79;790;863;1653
2020-10-12;BU;>80;777;1409;2186
2020-10-12;LE;>80;1039;1952;2991
2020-10-12;VA;>80;975;1939;2914
2020-10-12;AV;0-9;253;226;479
2020-10-12;BU;0-9;796;666;1462
2020-10-12;LE;0-9;588;514;1102
2020-10-12;SA;0-9;654;635;1289
2020-10-12;VA;0-9;1074;913;1987
2020-10-12;PA;10-19;288;271;559
2020-10-12;CyL;10-19;4273;4043;8316
2020-10-12;AV;20-29;313;382;695
2020-10-12;CyL;20-29;5723;6729;12452
2020-10-12;ZA;30-39;260;360;620
2020-10-12;LE;40-49;1403;2026;3429
2020-10-12;PA;40-49;606;720;1326
2020-10-12;BU;50-59;1390;1916;3306
2020-10-12;PA;50-59;594;747;1341
2020-10-12;SA;50-59;1476;2107;3583
2020-10-12;VA;50-59;1671;2316;3987
2020-10-12;ZA;50-59;413;597;1010
2020-10-12;BU;60-69;997;1114;2111
2020-10-12;PA;60-69;489;518;1007
2020-10-12;SO;60-69;340;411;751
2020-10-12;CyL;60-69;7118;8114;15232
2020-10-12;BU;70-79;658;677;1335
2020-10-12;LE;70-79;904;852;1756
2020-10-12;SE;70-79;518;516;1034
2020-10-12;VA;70-79;966;1045;2011
2020-10-12;CyL;70-79;5063;5196;10259
2020-10-12;SA;>80;1039;1892;2931
2020-10-12;SO;>80;445;789;1234
2020-10-12;ZA;>80;354;599;953
2020-10-12;PA;0-9;227;201;428
2020-10-12;SE;0-9;422;390;812
2020-10-12;SO;10-19;152;142;294
2020-10-12;BU;20-29;1047;1202;2249
2020-10-12;SA;20-29;956;1155;2111
2020-10-12;SE;20-29;445;579;1024
2020-10-12;AV;30-39;428;577;1005
2020-10-12;LE;30-39;987;1481;2468
2020-10-12;PA;30-39;440;535;975
2020-10-12;SA;30-39;1077;1461;2538
2020-10-12;SO;30-39;305;413;718
2020-10-12;VA;30-39;1508;1946;3454
2020-10-12;AV;40-49;619;801;1420
2020-10-12;BU;40-49;1628;1923;3551
2020-10-12;SE;40-49;811;1126;1937
2020-10-12;ZA;40-49;350;519;869
2020-10-12;CyL;40-49;9130;12170;21300
2020-10-12;AV;50-59;572;872;1444
2020-10-12;LE;50-59;1344;1944;3288
2020-10-12;SE;50-59;945;1403;2348
2020-10-12;CyL;50-59;8857;12600;21457
2020-10-12;LE;60-69;1164;1361;2525
2020-10-12;SA;60-69;1145;1279;2424
2020-10-12;ZA;60-69;365;402;767
2020-10-12;PA;70-79;340;343;683
2020-10-12;SO;70-79;236;216;452
2020-10-12;ZA;70-79;266;259;525
2020-10-12;AV;>80;501;854;1355
2020-10-12;PA;>80;324;598;922
2020-10-12;SE;>80;725;1194;1919
2020-10-12;CyL;>80;6179;11226;17405
2020-10-08;SA;0-9;637;621;1258
2020-10-08;SO;0-9;157;140;297
2020-10-08;BU;10-19;785;680;1465
2020-10-08;VA;10-19;934;916;1850
2020-10-08;LE;20-29;806;951;1757
2020-10-08;PA;20-29;374;386;760
2020-10-08;VA;20-29;1236;1433;2669
2020-10-08;VA;30-39;1476;1922;3398
2020-10-08;ZA;30-39;255;349;604
2020-10-08;LE;40-49;1347;1963;3310
2020-10-08;PA;40-49;591;694;1285
2020-10-08;SA;40-49;1299;1737;3036
2020-10-08;VA;40-49;1913;2637;4550
2020-10-08;CyL;40-49;8916;11938;20854
2020-10-08;PA;50-59;577;732;1309
2020-10-08;SA;50-59;1447;2074;3521
2020-10-08;LE;60-69;1108;1301;2409
2020-10-08;SA;60-69;1115;1255;2370
2020-10-08;SO;60-69;339;408;747
2020-10-08;VA;60-69;1267;1558;2825
2020-10-08;AV;70-79;377;418;795
2020-10-08;LE;70-79;869;827;1696
2020-10-08;CyL;70-79;4956;5105;10061
2020-10-08;LE;>80;982;1818;2800
2020-10-08;PA;>80;320;585;905
2020-10-08;SE;>80;721;1188;1909
2020-10-08;SO;>80;443;786;1229
2020-10-08;ZA;>80;350;593;943
2020-10-08;CyL;>80;6061;10984;17045
2020-10-08;BU;0-9;770;639;1409
2020-10-08;PA;0-9;213;192;405
2020-10-08;SE;0-9;409;381;790
2020-10-08;ZA;0-9;276;265;541
2020-10-08;CyL;0-9;4346;3864;8210
2020-10-08;PA;10-19;267;257;524
2020-10-08;SA;10-19;611;616;1227
2020-10-08;ZA;10-19;174;169;343
2020-10-08;AV;20-29;307;368;675
2020-10-08;SE;20-29;430;574;1004
2020-10-08;SO;20-29;252;318;570
2020-10-08;CyL;20-29;5527;6544;12071
2020-10-08;AV;30-39;423;567;990
2020-10-08;BU;30-39;1229;1488;2717
2020-10-08;SA;30-39;1054;1433;2487
2020-10-08;SE;30-39;580;753;1333
2020-10-08;SO;30-39;301;409;710
2020-10-08;AV;40-49;611;789;1400
2020-10-08;BU;40-49;1584;1888;3472
2020-10-08;SO;40-49;424;605;1029
2020-10-08;ZA;40-49;341;508;849
2020-10-08;SO;50-59;446;695;1141
2020-10-08;AV;60-69;520;585;1105
2020-10-08;PA;60-69;474;511;985
2020-10-08;CyL;60-69;6941;7952;14893
2020-10-08;PA;70-79;330;338;668
2020-10-08;SA;70-79;779;854;1633
2020-10-08;SE;70-79;513;515;1028
2020-10-08;VA;>80;961;1907;2868
2020-10-08;AV;0-9;247;223;470
2020-10-08;LE;0-9;578;504;1082
2020-10-08;VA;0-9;1059;899;1958
2020-10-08;AV;10-19;238;221;459
2020-10-08;LE;10-19;620;577;1197
2020-10-08;SE;10-19;351;312;663
2020-10-08;SO;10-19;146;138;284
2020-10-08;CyL;10-19;4126;3886;8012
2020-10-08;BU;20-29;1015;1163;2178
2020-10-08;SA;20-29;913;1116;2029
2020-10-08;ZA;20-29;194;235;429
2020-10-08;LE;30-39;953;1442;2395
2020-10-08;PA;30-39;426;526;952
2020-10-08;CyL;30-39;6697;8889;15586
2020-10-08;SE;40-49;806;1117;1923
2020-10-08;AV;50-59;555;860;1415
2020-10-08;BU;50-59;1345;1882;3227
2020-10-08;LE;50-59;1289;1882;3171
2020-10-08;SE;50-59;935;1390;2325
2020-10-08;VA;50-59;1619;2270;3889
2020-10-08;ZA;50-59;408;580;988
2020-10-08;CyL;50-59;8621;12365;20986
2020-10-08;BU;60-69;977;1093;2070
2020-10-08;SE;60-69;782;846;1628
2020-10-08;ZA;60-69;359;395;754
2020-10-08;BU;70-79;646;664;1310
2020-10-08;SO;70-79;233;214;447
2020-10-08;VA;70-79;951;1023;1974
2020-10-08;ZA;70-79;258;252;510
2020-10-08;AV;>80;494;847;1341
2020-10-08;BU;>80;767;1397;2164
2020-10-08;SA;>80;1023;1863;2886
2020-10-07;AV;0-9;249;220;469
2020-10-07;BU;0-9;765;627;1392
2020-10-07;LE;0-9;576;497;1073
2020-10-07;SA;0-9;648;615;1263
2020-10-07;SE;0-9;410;377;787
2020-10-07;BU;10-19;779;675;1454
2020-10-07;SA;10-19;601;598;1199
2020-10-07;SO;10-19;144;137;281
2020-10-07;AV;20-29;308;367;675
2020-10-07;LE;20-29;789;935;1724
2020-10-07;ZA;20-29;192;233;425
2020-10-07;CyL;20-29;5461;6473;11934
2020-10-07;BU;30-39;1213;1477;2690
2020-10-07;SO;30-39;299;408;707
2020-10-07;ZA;30-39;252;345;597
2020-10-07;CyL;30-39;6629;8825;15454
2020-10-07;BU;40-49;1562;1869;3431
2020-10-07;LE;40-49;1331;1943;3274
2020-10-07;PA;40-49;584;690;1274
2020-10-07;SA;40-49;1289;1727;3016
2020-10-07;SE;40-49;801;1115;1916
2020-10-07;SO;40-49;424;601;1025
2020-10-07;VA;40-49;1899;2617;4516
2020-10-07;LE;50-59;1265;1860;3125
2020-10-07;SA;50-59;1441;2064;3505
2020-10-07;SE;50-59;933;1390;2323
2020-10-07;VA;50-59;1605;2251;3856
2020-10-07;CyL;50-59;8555;12270;20825
2020-10-07;AV;60-69;516;579;1095
2020-10-07;BU;60-69;966;1078;2044
2020-10-07;LE;60-69;1098;1293;2391
2020-10-07;LE;70-79;861;813;1674
2020-10-07;ZA;70-79;255;252;507
2020-10-07;AV;>80;492;843;1335
2020-10-07;SA;>80;1020;1850;2870
2020-10-07;SO;>80;443;784;1227
2020-10-07;CyL;>80;6022;10876;16898
2020-10-07;PA;0-9;212;186;398
2020-10-07;ZA;0-9;275;265;540
2020-10-07;AV;10-19;236;219;455
2020-10-07;LE;10-19;613;567;1180
2020-10-07;PA;10-19;255;250;505
2020-10-07;VA;10-19;929;906;1835
2020-10-07;ZA;10-19;174;168;342
2020-10-07;CyL;10-19;4081;3828;7909
2020-10-07;BU;20-29;1003;1153;2156
2020-10-07;PA;20-29;374;380;754
2020-10-07;SA;20-29;902;1098;2000
2020-10-07;SE;20-29;424;572;996
2020-10-07;LE;30-39;938;1425;2363
2020-10-07;SE;30-39;577;749;1326
2020-10-07;VA;30-39;1460;1909;3369
2020-10-07;AV;40-49;608;786;1394
2020-10-07;CyL;40-49;8836;11855;20691
2020-10-07;BU;50-59;1339;1855;3194
2020-10-07;PA;50-59;572;725;1297
2020-10-07;ZA;50-59;405;575;980
2020-10-07;PA;60-69;468;506;974
2020-10-07;SA;60-69;1108;1245;2353
2020-10-07;SE;60-69;779;844;1623
2020-10-07;SO;60-69;338;408;746
2020-10-07;ZA;60-69;355;388;743
2020-10-07;AV;70-79;377;419;796
2020-10-07;PA;70-79;325;331;656
2020-10-07;SE;70-79;510;516;1026
2020-10-07;VA;70-79;939;1005;1944
2020-10-07;PA;>80;317;583;900
2020-10-07;VA;>80;948;1869;2817
2020-10-07;SO;0-9;157;139;296
2020-10-07;VA;0-9;1052;894;1946
2020-10-07;CyL;0-9;4344;3820;8164
2020-10-07;SE;10-19;350;308;658
2020-10-07;SO;20-29;249;317;566
2020-10-07;VA;20-29;1220;1418;2638
2020-10-07;AV;30-39;423;564;987
2020-10-07;PA;30-39;420;523;943
2020-10-07;SA;30-39;1047;1425;2472
2020-10-07;ZA;40-49;338;507;845
2020-10-07;AV;50-59;551;856;1407
2020-10-07;SO;50-59;444;694;1138
2020-10-07;VA;60-69;1255;1547;2802
2020-10-07;CyL;60-69;6883;7888;14771
2020-10-07;BU;70-79;639;657;1296
2020-10-07;SA;70-79;772;848;1620
2020-10-07;SO;70-79;231;213;444
2020-10-07;CyL;70-79;4909;5054;9963
2020-10-07;BU;>80;759;1379;2138
2020-10-07;LE;>80;973;1798;2771
2020-10-07;SE;>80;721;1181;1902
2020-10-07;ZA;>80;349;589;938
2020-10-06;PA;0-9;214;185;399
2020-10-06;SA;0-9;646;607;1253
2020-10-06;SE;0-9;408;373;781
2020-10-06;SO;0-9;157;138;295
2020-10-06;CyL;0-9;4307;3790;8097
2020-10-06;LE;10-19;604;557;1161
2020-10-06;PA;10-19;254;245;499
2020-10-06;BU;20-29;992;1139;2131
2020-10-06;PA;20-29;368;375;743
2020-10-06;ZA;20-29;192;232;424
2020-10-06;BU;30-39;1209;1464;2673
2020-10-06;SE;30-39;571;746;1317
2020-10-06;ZA;30-39;250;343;593
2020-10-06;AV;40-49;608;786;1394
2020-10-06;LE;40-49;1319;1925;3244
2020-10-06;CyL;40-49;8774;11777;20551
2020-10-06;SA;50-59;1425;2036;3461
2020-10-06;ZA;50-59;403;574;977
2020-10-06;BU;60-69;957;1067;2024
2020-10-06;CyL;60-69;6819;7824;14643
2020-10-06;AV;70-79;376;416;792
2020-10-06;SA;70-79;759;836;1595
2020-10-06;CyL;70-79;4875;5004;9879
2020-10-06;AV;>80;492;842;1334
2020-10-06;SE;>80;718;1177;1895
2020-10-06;VA;>80;941;1862;2803
2020-10-06;BU;0-9;757;619;1376
2020-10-06;VA;0-9;1037;885;1922
2020-10-06;BU;10-19;768;665;1433
2020-10-06;SE;10-19;340;306;646
2020-10-06;SO;10-19;144;135;279
2020-10-06;VA;10-19;901;890;1791
2020-10-06;ZA;10-19;173;166;339
2020-10-06;CyL;10-19;4006;3772;7778
2020-10-06;SE;20-29;418;574;992
2020-10-06;CyL;20-29;5379;6405;11784
2020-10-06;AV;30-39;419;561;980
2020-10-06;PA;30-39;418;520;938
2020-10-06;SO;30-39;298;407;705
2020-10-06;CyL;30-39;6565;8745;15310
2020-10-06;BU;40-49;1558;1862;3420
2020-10-06;SE;40-49;794;1113;1907
2020-10-06;SO;40-49;421;598;1019
2020-10-06;VA;40-49;1882;2592;4474
2020-10-06;AV;50-59;551;852;1403
2020-10-06;BU;50-59;1328;1841;3169
2020-10-06;LE;50-59;1238;1836;3074
2020-10-06;PA;50-59;569;717;1286
2020-10-06;CyL;50-59;8478;12160;20638
2020-10-06;LE;60-69;1084;1284;2368
2020-10-06;SA;60-69;1093;1228;2321
2020-10-06;SE;60-69;777;838;1615
2020-10-06;SO;60-69;337;406;743
2020-10-06;ZA;60-69;353;386;739
2020-10-06;BU;70-79;637;650;1287
2020-10-06;LE;70-79;853;801;1654
2020-10-06;SE;70-79;511;513;1024
2020-10-06;SO;70-79;229;213;442
2020-10-06;VA;70-79;932;996;1928
2020-10-06;BU;>80;759;1373;2132
2020-10-06;SA;>80;1015;1823;2838
2020-10-06;AV;0-9;248;220;468
2020-10-06;LE;0-9;567;498;1065
2020-10-06;ZA;0-9;273;265;538
2020-10-06;AV;10-19;236;219;455
2020-10-06;SA;10-19;586;589;1175
2020-10-06;AV;20-29;304;365;669
2020-10-06;LE;20-29;777;920;1697
2020-10-06;SA;20-29;871;1075;1946
2020-10-06;SO;20-29;247;317;564
2020-10-06;VA;20-29;1210;1408;2618
2020-10-06;LE;30-39;921;1408;2329
2020-10-06;SA;30-39;1035;1407;2442
2020-10-06;VA;30-39;1444;1889;3333
2020-10-06;PA;40-49;581;688;1269
2020-10-06;SA;40-49;1275;1709;2984
2020-10-06;ZA;40-49;336;504;840
2020-10-06;SE;50-59;929;1390;2319
2020-10-06;SO;50-59;442;693;1135
2020-10-06;VA;50-59;1593;2221;3814
2020-10-06;AV;60-69;512;577;1089
2020-10-06;PA;60-69;464;503;967
2020-10-06;VA;60-69;1242;1535;2777
2020-10-06;PA;70-79;324;328;652
2020-10-06;ZA;70-79;254;251;505
2020-10-06;LE;>80;970;1788;2758
2020-10-06;PA;>80;313;583;896
2020-10-06;SO;>80;442;783;1225
2020-10-06;ZA;>80;346;586;932
2020-10-06;CyL;>80;5996;10817;16813
2020-10-05;SA;0-9;638;604;1242
2020-10-05;VA;0-9;1025;872;1897
2020-10-05;AV;10-19;235;218;453
2020-10-05;LE;10-19;588;553;1141
2020-10-05;PA;10-19;251;235;486
2020-10-05;SA;10-19;572;574;1146
2020-10-05;SE;10-19;329;301;630
2020-10-05;SO;10-19;144;136;280
2020-10-05;LE;20-29;765;912;1677
2020-10-05;CyL;20-29;5323;6341;11664
2020-10-05;VA;40-49;1870;2568;4438
2020-10-05;AV;50-59;547;847;1394
2020-10-05;SA;50-59;1418;2024;3442
2020-10-05;SE;50-59;924;1387;2311
2020-10-05;SO;50-59;441;693;1134
2020-10-05;CyL;50-59;8414;12091;20505
2020-10-05;LE;60-69;1074;1272;2346
2020-10-05;PA;60-69;455;498;953
2020-10-05;SE;60-69;774;835;1609
2020-10-05;VA;60-69;1229;1515;2744
2020-10-05;AV;70-79;373;414;787
2020-10-05;BU;70-79;634;644;1278
2020-10-05;SA;70-79;754;835;1589
2020-10-05;SE;70-79;511;513;1024
2020-10-05;VA;70-79;917;983;1900
2020-10-05;ZA;70-79;250;245;495
2020-10-05;CyL;70-79;4836;4972;9808
2020-10-05;AV;>80;492;842;1334
2020-10-05;PA;>80;312;582;894
2020-10-05;SE;>80;714;1175;1889
2020-10-05;SO;>80;442;782;1224
2020-10-05;ZA;>80;346;583;929
2020-10-05;AV;0-9;243;218;461
2020-10-05;BU;0-9;737;608;1345
2020-10-05;LE;0-9;564;492;1056
2020-10-05;ZA;0-9;272;263;535
2020-10-05;CyL;0-9;4251;3749;8000
2020-10-05;VA;10-19;877;882;1759
2020-10-05;AV;20-29;300;361;661
2020-10-05;BU;20-29;985;1122;2107
2020-10-05;PA;20-29;363;369;732
2020-10-05;SO;20-29;247;315;562
2020-10-05;BU;30-39;1197;1453;2650
2020-10-05;VA;30-39;1430;1869;3299
2020-10-05;CyL;30-39;6505;8661;15166
2020-10-05;BU;40-49;1545;1849;3394
2020-10-05;LE;40-49;1309;1903;3212
2020-10-05;SA;40-49;1261;1696;2957
2020-10-05;ZA;40-49;333;501;834
2020-10-05;LE;50-59;1222;1825;3047
2020-10-05;VA;50-59;1582;2204;3786
2020-10-05;AV;60-69;504;576;1080
2020-10-05;SO;60-69;336;407;743
2020-10-05;ZA;60-69;348;383;731
2020-10-05;CyL;60-69;6756;7765;14521
2020-10-05;PA;70-79;319;325;644
2020-10-05;LE;>80;963;1774;2737
2020-10-05;VA;>80;928;1824;2752
2020-10-05;PA;0-9;211;183;394
2020-10-05;SE;0-9;404;371;775
2020-10-05;SO;0-9;157;138;295
2020-10-05;BU;10-19;743;654;1397
2020-10-05;ZA;10-19;173;167;340
2020-10-05;CyL;10-19;3912;3720;7632
2020-10-05;SA;20-29;858;1066;1924
2020-10-05;SE;20-29;415;571;986
2020-10-05;VA;20-29;1202;1396;2598
2020-10-05;ZA;20-29;188;229;417
2020-10-05;AV;30-39;414;558;972
2020-10-05;LE;30-39;915;1387;2302
2020-10-05;PA;30-39;417;510;927
2020-10-05;SA;30-39;1025;1399;2424
2020-10-05;SE;30-39;562;739;1301
2020-10-05;SO;30-39;297;406;703
2020-10-05;ZA;30-39;248;340;588
2020-10-05;AV;40-49;606;780;1386
2020-10-05;PA;40-49;576;687;1263
2020-10-05;SE;40-49;789;1113;1902
2020-10-05;SO;40-49;421;598;1019
2020-10-05;CyL;40-49;8710;11695;20405
2020-10-05;BU;50-59;1320;1828;3148
2020-10-05;PA;50-59;563;712;1275
2020-10-05;ZA;50-59;397;571;968
2020-10-05;BU;60-69;949;1059;2008
2020-10-05;SA;60-69;1087;1220;2307
2020-10-05;LE;70-79;849;800;1649
2020-10-05;SO;70-79;229;213;442
2020-10-05;BU;>80;756;1372;2128
2020-10-05;SA;>80;1009;1813;2822
2020-10-05;CyL;>80;5962;10747;16709
2020-10-04;BU;10-19;733;653;1386
2020-10-04;VA;10-19;868;881;1749
2020-10-04;CyL;10-19;3868;3686;7554
2020-10-04;BU;20-29;980;1113;2093
2020-10-04;SA;20-29;846;1060;1906
2020-10-04;SO;20-29;248;315;563
2020-10-04;ZA;20-29;188;228;416
2020-10-04;CyL;20-29;5286;6294;11580
2020-10-04;AV;30-39;413;558;971
2020-10-04;BU;40-49;1531;1837;3368
2020-10-04;SA;40-49;1250;1693;2943
2020-10-04;VA;40-49;1855;2538;4393
2020-10-04;CyL;40-49;8646;11618;20264
2020-10-04;BU;50-59;1310;1810;3120
2020-10-04;LE;50-59;1217;1819;3036
2020-10-04;ZA;50-59;396;568;964
2020-10-04;AV;60-69;500;575;1075
2020-10-04;LE;60-69;1072;1272;2344
2020-10-04;SO;60-69;336;406;742
2020-10-04;VA;60-69;1222;1504;2726
2020-10-04;ZA;60-69;348;383;731
2020-10-04;LE;70-79;850;800;1650
2020-10-04;PA;70-79;315;322;637
2020-10-04;SE;70-79;510;514;1024
2020-10-04;SO;70-79;229;213;442
2020-10-04;VA;70-79;909;974;1883
2020-10-04;CyL;70-79;4814;4952;9766
2020-10-04;AV;>80;490;841;1331
2020-10-04;PA;>80;311;577;888
2020-10-04;SA;>80;1005;1809;2814
2020-10-04;SO;>80;441;782;1223
2020-10-04;BU;0-9;730;599;1329
2020-10-04;PA;0-9;208;178;386
2020-10-04;SA;0-9;626;604;1230
2020-10-04;SE;0-9;399;375;774
2020-10-04;CyL;0-9;4212;3730;7942
2020-10-04;PA;10-19;249;228;477
2020-10-04;SA;10-19;565;563;1128
2020-10-04;ZA;10-19;170;167;337
2020-10-04;LE;20-29;758;905;1663
2020-10-04;PA;20-29;361;365;726
2020-10-04;LE;30-39;909;1379;2288
2020-10-04;SA;30-39;1020;1392;2412
2020-10-04;SE;30-39;557;737;1294
2020-10-04;ZA;30-39;247;339;586
2020-10-04;CyL;30-39;6458;8624;15082
2020-10-04;AV;40-49;597;775;1372
2020-10-04;SO;40-49;424;597;1021
2020-10-04;AV;50-59;546;847;1393
2020-10-04;SA;50-59;1410;2017;3427
2020-10-04;SO;50-59;441;693;1134
2020-10-04;VA;50-59;1564;2183;3747
2020-10-04;CyL;50-59;8363;12026;20389
2020-10-04;PA;60-69;450;494;944
2020-10-04;CyL;60-69;6722;7742;14464
2020-10-04;BU;>80;757;1365;2122
2020-10-04;SE;>80;710;1175;1885
2020-10-04;ZA;>80;345;583;928
2020-10-04;CyL;>80;5944;10711;16655
2020-10-04;AV;0-9;242;217;459
2020-10-04;LE;0-9;559;487;1046
2020-10-04;SO;0-9;157;138;295
2020-10-04;VA;0-9;1021;870;1891
2020-10-04;ZA;0-9;270;262;532
2020-10-04;AV;10-19;237;215;452
2020-10-04;LE;10-19;575;546;1121
2020-10-04;SE;10-19;329;295;624
2020-10-04;SO;10-19;142;138;280
2020-10-04;AV;20-29;296;359;655
2020-10-04;SE;20-29;414;570;984
2020-10-04;VA;20-29;1195;1379;2574
2020-10-04;BU;30-39;1182;1442;2624
2020-10-04;PA;30-39;412;509;921
2020-10-04;SO;30-39;296;406;702
2020-10-04;VA;30-39;1422;1862;3284
2020-10-04;LE;40-49;1305;1895;3200
2020-10-04;PA;40-49;565;676;1241
2020-10-04;SE;40-49;786;1107;1893
2020-10-04;ZA;40-49;333;500;833
2020-10-04;PA;50-59;555;709;1264
2020-10-04;SE;50-59;924;1380;2304
2020-10-04;BU;60-69;940;1056;1996
2020-10-04;SA;60-69;1083;1220;2303
2020-10-04;SE;60-69;771;832;1603
2020-10-04;AV;70-79;373;412;785
2020-10-04;BU;70-79;629;640;1269
2020-10-04;SA;70-79;750;833;1583
2020-10-04;ZA;70-79;249;244;493
2020-10-04;LE;>80;964;1771;2735
2020-10-04;VA;>80;921;1808;2729
2020-10-01;AV;0-9;234;213;447
2020-10-01;LE;0-9;546;470;1016
2020-10-01;PA;0-9;202;166;368
2020-10-01;SO;0-9;157;137;294
2020-10-01;VA;0-9;1008;843;1851
2020-10-01;ZA;0-9;269;261;530
2020-10-01;CyL;0-9;4152;3650;7802
2020-10-01;BU;10-19;708;636;1344
2020-10-01;CyL;10-19;3750;3598;7348
2020-10-01;LE;20-29;729;876;1605
2020-10-01;PA;20-29;349;353;702
2020-10-01;SA;20-29;835;1045;1880
2020-10-01;SE;20-29;407;563;970
2020-10-01;AV;30-39;407;549;956
2020-10-01;AV;40-49;589;767;1356
2020-10-01;LE;40-49;1273;1853;3126
2020-10-01;AV;50-59;539;840;1379
2020-10-01;SA;50-59;1394;1995;3389
2020-10-01;SO;50-59;439;692;1131
2020-10-01;LE;60-69;1050;1252;2302
2020-10-01;SE;60-69;764;830;1594
2020-10-01;PA;70-79;308;321;629
2020-10-01;VA;70-79;897;958;1855
2020-10-01;BU;>80;751;1353;2104
2020-10-01;SA;0-9;628;606;1234
2020-10-01;LE;10-19;539;525;1064
2020-10-01;PA;10-19;239;220;459
2020-10-01;SA;10-19;556;556;1112
2020-10-01;ZA;10-19;167;161;328
2020-10-01;BU;20-29;959;1093;2052
2020-10-01;SO;20-29;244;315;559
2020-10-01;ZA;20-29;182;224;406
2020-10-01;BU;30-39;1160;1418;2578
2020-10-01;PA;30-39;404;498;902
2020-10-01;SA;30-39;1006;1378;2384
2020-10-01;SE;30-39;555;734;1289
2020-10-01;BU;40-49;1509;1810;3319
2020-10-01;SA;40-49;1235;1682;2917
2020-10-01;SE;40-49;778;1096;1874
2020-10-01;ZA;40-49;331;495;826
2020-10-01;LE;50-59;1185;1768;2953
2020-10-01;SE;50-59;921;1372;2293
2020-10-01;CyL;50-59;8245;11872;20117
2020-10-01;AV;60-69;492;565;1057
2020-10-01;BU;60-69;928;1036;1964
2020-10-01;PA;60-69;437;478;915
2020-10-01;SA;60-69;1068;1208;2276
2020-10-01;SO;60-69;335;405;740
2020-10-01;VA;60-69;1197;1481;2678
2020-10-01;CyL;60-69;6610;7637;14247
2020-10-01;AV;70-79;368;410;778
2020-10-01;LE;70-79;832;785;1617
2020-10-01;ZA;70-79;247;241;488
2020-10-01;AV;>80;489;835;1324
2020-10-01;LE;>80;943;1727;2670
2020-10-01;PA;>80;305;570;875
2020-10-01;SE;>80;709;1165;1874
2020-10-01;SO;>80;439;780;1219
2020-10-01;ZA;>80;338;566;904
2020-10-01;CyL;>80;5876;10595;16471
2020-10-01;BU;0-9;713;585;1298
2020-10-01;SE;0-9;395;369;764
2020-10-01;AV;10-19;225;211;436
2020-10-01;SE;10-19;323;290;613
2020-10-01;SO;10-19;140;139;279
2020-10-01;VA;10-19;853;860;1713
2020-10-01;AV;20-29;290;348;638
2020-10-01;VA;20-29;1159;1347;2506
2020-10-01;CyL;20-29;5154;6164;11318
2020-10-01;LE;30-39;884;1354;2238
2020-10-01;SO;30-39;294;403;697
2020-10-01;VA;30-39;1408;1833;3241
2020-10-01;ZA;30-39;245;331;576
2020-10-01;CyL;30-39;6363;8498;14861
2020-10-01;PA;40-49;550;659;1209
2020-10-01;SO;40-49;419;593;1012
2020-10-01;VA;40-49;1820;2498;4318
2020-10-01;CyL;40-49;8504;11453;19957
2020-10-01;BU;50-59;1298;1792;3090
2020-10-01;PA;50-59;541;698;1239
2020-10-01;VA;50-59;1539;2158;3697
2020-10-01;ZA;50-59;389;557;946
2020-10-01;ZA;60-69;339;382;721
2020-10-01;BU;70-79;618;628;1246
2020-10-01;SA;70-79;744;823;1567
2020-10-01;SE;70-79;510;512;1022
2020-10-01;SO;70-79;229;213;442
2020-10-01;CyL;70-79;4753;4891;9644
2020-10-01;SA;>80;993;1801;2794
2020-10-01;VA;>80;909;1798;2707
2020-09-30;AV;0-9;231;212;443
2020-09-30;LE;0-9;538;460;998
2020-09-30;SE;0-9;387;365;752
2020-09-30;ZA;0-9;267;259;526
2020-09-30;AV;10-19;221;209;430
2020-09-30;BU;10-19;715;634;1349
2020-09-30;LE;10-19;507;505;1012
2020-09-30;SO;10-19;140;135;275
2020-09-30;VA;10-19;838;848;1686
2020-09-30;LE;20-29;711;857;1568
2020-09-30;PA;20-29;346;351;697
2020-09-30;SA;20-29;819;1036;1855
2020-09-30;VA;20-29;1150;1335;2485
2020-09-30;LE;30-39;865;1336;2201
2020-09-30;PA;30-39;403;491;894
2020-09-30;SE;30-39;553;724;1277
2020-09-30;SO;30-39;294;401;695
2020-09-30;VA;30-39;1396;1825;3221
2020-09-30;ZA;30-39;244;328;572
2020-09-30;CyL;30-39;6318;8439;14757
2020-09-30;SA;40-49;1231;1669;2900
2020-09-30;AV;50-59;535;838;1373
2020-09-30;PA;50-59;535;685;1220
2020-09-30;SA;50-59;1380;1984;3364
2020-09-30;SO;50-59;440;692;1132
2020-09-30;CyL;50-59;8162;11754;19916
2020-09-30;LE;60-69;1033;1237;2270
2020-09-30;SE;60-69;761;828;1589
2020-09-30;VA;60-69;1185;1473;2658
2020-09-30;ZA;60-69;336;380;716
2020-09-30;CyL;60-69;6552;7587;14139
2020-09-30;AV;70-79;364;407;771
2020-09-30;LE;70-79;821;772;1593
2020-09-30;SA;70-79;742;816;1558
2020-09-30;VA;>80;904;1790;2694
2020-09-30;BU;0-9;706;592;1298
2020-09-30;PA;0-9;199;164;363
2020-09-30;SA;0-9;617;599;1216
2020-09-30;SO;0-9;158;137;295
2020-09-30;VA;0-9;1008;838;1846
2020-09-30;PA;10-19;235;216;451
2020-09-30;SA;10-19;548;542;1090
2020-09-30;SE;10-19;319;287;606
2020-09-30;ZA;10-19;166;159;325
2020-09-30;CyL;10-19;3689;3535;7224
2020-09-30;AV;20-29;283;348;631
2020-09-30;SO;20-29;243;315;558
2020-09-30;ZA;20-29;181;221;402
2020-09-30;SA;30-39;1005;1375;2380
2020-09-30;AV;40-49;587;767;1354
2020-09-30;VA;40-49;1805;2469;4274
2020-09-30;ZA;40-49;328;491;819
2020-09-30;CyL;40-49;8435;11351;19786
2020-09-30;BU;50-59;1286;1775;3061
2020-09-30;LE;50-59;1167;1733;2900
2020-09-30;BU;60-69;918;1025;1943
2020-09-30;PA;60-69;430;470;900
2020-09-30;PA;70-79;304;315;619
2020-09-30;SE;70-79;508;511;1019
2020-09-30;VA;70-79;889;950;1839
2020-09-30;ZA;70-79;247;239;486
2020-09-30;AV;>80;489;832;1321
2020-09-30;BU;>80;747;1349;2096
2020-09-30;PA;>80;305;565;870
2020-09-30;SE;>80;704;1152;1856
2020-09-30;SO;>80;439;778;1217
2020-09-30;ZA;>80;336;566;902
2020-09-30;CyL;0-9;4111;3626;7737
2020-09-30;BU;20-29;946;1081;2027
2020-09-30;SE;20-29;406;560;966
2020-09-30;CyL;20-29;5085;6104;11189
2020-09-30;AV;30-39;405;548;953
2020-09-30;BU;30-39;1153;1411;2564
2020-09-30;BU;40-49;1503;1797;3300
2020-09-30;LE;40-49;1247;1820;3067
2020-09-30;PA;40-49;541;652;1193
2020-09-30;SE;40-49;776;1093;1869
2020-09-30;SO;40-49;417;593;1010
2020-09-30;SE;50-59;918;1364;2282
2020-09-30;VA;50-59;1513;2135;3648
2020-09-30;ZA;50-59;388;548;936
2020-09-30;AV;60-69;490;563;1053
2020-09-30;SA;60-69;1064;1206;2270
2020-09-30;SO;60-69;335;405;740
2020-09-30;BU;70-79;616;624;1240
2020-09-30;SO;70-79;229;213;442
2020-09-30;CyL;70-79;4720;4847;9567
2020-09-30;LE;>80;932;1703;2635
2020-09-30;SA;>80;991;1797;2788
2020-09-30;CyL;>80;5847;10532;16379
2020-09-29;BU;0-9;666;567;1233
2020-09-29;SO;0-9;155;136;291
2020-09-29;CyL;0-9;3986;3504;7490
2020-09-29;AV;10-19;215;205;420
2020-09-29;LE;10-19;486;493;979
2020-09-29;SA;10-19;527;538;1065
2020-09-29;SO;10-19;136;131;267
2020-09-29;VA;10-19;817;831;1648
2020-09-29;AV;20-29;276;340;616
2020-09-29;SE;20-29;397;552;949
2020-09-29;LE;30-39;852;1319;2171
2020-09-29;SA;30-39;989;1356;2345
2020-09-29;CyL;30-39;6216;8328;14544
2020-09-29;BU;40-49;1476;1768;3244
2020-09-29;PA;40-49;532;634;1166
2020-09-29;SE;40-49;772;1081;1853
2020-09-29;SO;40-49;418;593;1011
2020-09-29;AV;50-59;528;833;1361
2020-09-29;LE;50-59;1157;1716;2873
2020-09-29;SA;50-59;1380;1963;3343
2020-09-29;SE;50-59;912;1353;2265
2020-09-29;SO;50-59;439;685;1124
2020-09-29;PA;60-69;427;466;893
2020-09-29;SE;60-69;759;822;1581
2020-09-29;ZA;60-69;333;377;710
2020-09-29;BU;70-79;606;617;1223
2020-09-29;PA;70-79;296;310;606
2020-09-29;ZA;70-79;241;235;476
2020-09-29;BU;>80;739;1336;2075
2020-09-29;SA;>80;984;1787;2771
2020-09-29;SO;>80;438;774;1212
2020-09-29;ZA;>80;331;554;885
2020-09-29;CyL;>80;5782;10443;16225
2020-09-29;AV;0-9;229;209;438
2020-09-29;PA;0-9;194;160;354
2020-09-29;ZA;0-9;263;255;518
2020-09-29;PA;10-19;229;207;436
2020-09-29;SE;10-19;306;284;590
2020-09-29;ZA;10-19;161;151;312
2020-09-29;CyL;10-19;3544;3434;6978
2020-09-29;BU;20-29;925;1058;1983
2020-09-29;LE;20-29;704;839;1543
2020-09-29;SA;20-29;818;1019;1837
2020-09-29;SO;20-29;244;311;555
2020-09-29;AV;30-39;397;539;936
2020-09-29;BU;30-39;1129;1378;2507
2020-09-29;SO;30-39;292;401;693
2020-09-29;AV;40-49;586;761;1347
2020-09-29;VA;40-49;1793;2441;4234
2020-09-29;ZA;40-49;328;485;813
2020-09-29;BU;50-59;1266;1755;3021
2020-09-29;VA;50-59;1504;2120;3624
2020-09-29;ZA;50-59;383;545;928
2020-09-29;VA;60-69;1161;1450;2611
2020-09-29;AV;70-79;361;405;766
2020-09-29;SA;70-79;734;812;1546
2020-09-29;SO;70-79;229;212;441
2020-09-29;AV;>80;487;829;1316
2020-09-29;VA;>80;890;1782;2672
2020-09-29;LE;0-9;522;439;961
2020-09-29;SA;0-9;594;578;1172
2020-09-29;SE;0-9;386;356;742
2020-09-29;VA;0-9;977;804;1781
2020-09-29;BU;10-19;667;594;1261
2020-09-29;PA;20-29;338;343;681
2020-09-29;VA;20-29;1139;1314;2453
2020-09-29;ZA;20-29;172;219;391
2020-09-29;CyL;20-29;5013;5995;11008
2020-09-29;PA;30-39;392;483;875
2020-09-29;SE;30-39;542;718;1260
2020-09-29;VA;30-39;1383;1812;3195
2020-09-29;ZA;30-39;240;322;562
2020-09-29;LE;40-49;1228;1799;3027
2020-09-29;SA;40-49;1219;1654;2873
2020-09-29;CyL;40-49;8352;11216;19568
2020-09-29;PA;50-59;522;671;1193
2020-09-29;CyL;50-59;8091;11641;19732
2020-09-29;AV;60-69;487;557;1044
2020-09-29;BU;60-69;899;1016;1915
2020-09-29;LE;60-69;1012;1229;2241
2020-09-29;SA;60-69;1048;1191;2239
2020-09-29;SO;60-69;335;405;740
2020-09-29;CyL;60-69;6461;7513;13974
2020-09-29;LE;70-79;816;762;1578
2020-09-29;SE;70-79;505;511;1016
2020-09-29;VA;70-79;879;945;1824
2020-09-29;CyL;70-79;4667;4809;9476
2020-09-29;LE;>80;919;1670;2589
2020-09-29;PA;>80;300;563;863
2020-09-29;SE;>80;694;1148;1842
2020-09-28;LE;0-9;517;432;949
2020-09-28;SA;0-9;579;570;1149
2020-09-28;VA;0-9;970;799;1769
2020-09-28;CyL;0-9;3941;3467;7408
2020-09-28;BU;10-19;662;583;1245
2020-09-28;SA;10-19;514;531;1045
2020-09-28;SE;10-19;302;280;582
2020-09-28;ZA;10-19;160;150;310
2020-09-28;SE;20-29;395;552;947
2020-09-28;AV;30-39;397;539;936
2020-09-28;PA;30-39;388;480;868
2020-09-28;SA;30-39;986;1345;2331
2020-09-28;VA;30-39;1373;1794;3167
2020-09-28;ZA;30-39;239;321;560
2020-09-28;LE;40-49;1219;1781;3000
2020-09-28;SA;40-49;1207;1641;2848
2020-09-28;SE;40-49;769;1077;1846
2020-09-28;SO;40-49;417;594;1011
2020-09-28;CyL;50-59;8034;11589;19623
2020-09-28;AV;60-69;485;554;1039
2020-09-28;LE;60-69;1001;1220;2221
2020-09-28;PA;60-69;425;463;888
2020-09-28;ZA;60-69;332;375;707
2020-09-28;CyL;60-69;6418;7478;13896
2020-09-28;SO;70-79;229;212;441
2020-09-28;VA;70-79;874;934;1808
2020-09-28;SA;>80;985;1778;2763
2020-09-28;SE;>80;693;1148;1841
2020-09-28;AV;0-9;228;206;434
2020-09-28;SO;0-9;153;134;287
2020-09-28;ZA;0-9;262;254;516
2020-09-28;AV;10-19;214;202;416
2020-09-28;LE;10-19;475;483;958
2020-09-28;CyL;10-19;3501;3381;6882
2020-09-28;AV;20-29;273;338;611
2020-09-28;BU;20-29;917;1046;1963
2020-09-28;PA;20-29;335;340;675
2020-09-28;ZA;20-29;169;218;387
2020-09-28;CyL;20-29;4976;5934;10910
2020-09-28;LE;30-39;846;1311;2157
2020-09-28;CyL;30-39;6172;8276;14448
2020-09-28;AV;40-49;584;759;1343
2020-09-28;BU;40-49;1470;1754;3224
2020-09-28;VA;40-49;1781;2424;4205
2020-09-28;ZA;40-49;326;480;806
2020-09-28;LE;50-59;1148;1707;2855
2020-09-28;SA;50-59;1369;1957;3326
2020-09-28;SE;50-59;906;1351;2257
2020-09-28;VA;50-59;1491;2109;3600
2020-09-28;ZA;50-59;381;542;923
2020-09-28;SA;60-69;1039;1188;2227
2020-09-28;SO;60-69;334;405;739
2020-09-28;BU;70-79;603;614;1217
2020-09-28;LE;70-79;811;756;1567
2020-09-28;SA;70-79;733;808;1541
2020-09-28;SE;70-79;504;508;1012
2020-09-28;ZA;70-79;240;233;473
2020-09-28;AV;>80;486;828;1314
2020-09-28;VA;>80;887;1773;2660
2020-09-28;ZA;>80;327;553;880
2020-09-28;BU;0-9;660;562;1222
2020-09-28;PA;0-9;191;158;349
2020-09-28;SE;0-9;381;352;733
2020-09-28;PA;10-19;226;204;430
2020-09-28;SO;10-19;136;131;267
2020-09-28;VA;10-19;812;817;1629
2020-09-28;LE;20-29;696;824;1520
2020-09-28;SA;20-29;814;1007;1821
2020-09-28;SO;20-29;244;308;552
2020-09-28;VA;20-29;1133;1301;2434
2020-09-28;BU;30-39;1114;1373;2487
2020-09-28;SE;30-39;537;715;1252
2020-09-28;SO;30-39;292;398;690
2020-09-28;PA;40-49;529;633;1162
2020-09-28;CyL;40-49;8302;11143;19445
2020-09-28;AV;50-59;525;830;1355
2020-09-28;BU;50-59;1256;1742;2998
2020-09-28;PA;50-59;519;666;1185
2020-09-28;SO;50-59;439;685;1124
2020-09-28;BU;60-69;890;1013;1903
2020-09-28;SE;60-69;758;821;1579
2020-09-28;VA;60-69;1154;1439;2593
2020-09-28;AV;70-79;361;405;766
2020-09-28;PA;70-79;296;307;603
2020-09-28;CyL;70-79;4651;4777;9428
2020-09-28;BU;>80;735;1332;2067
2020-09-28;LE;>80;915;1661;2576
2020-09-28;PA;>80;296;560;856
2020-09-28;SO;>80;438;774;1212
2020-09-28;CyL;>80;5762;10407;16169
2020-09-27;BU;0-9;652;548;1200
2020-09-27;LE;0-9;507;422;929
2020-09-27;SO;0-9;152;133;285
2020-09-27;VA;0-9;964;790;1754
2020-09-27;CyL;0-9;3894;3419;7313
2020-09-27;AV;10-19;209;200;409
2020-09-27;BU;10-19;645;569;1214
2020-09-27;LE;10-19;461;463;924
2020-09-27;VA;10-19;802;806;1608
2020-09-27;ZA;10-19;157;150;307
2020-09-27;SE;20-29;392;548;940
2020-09-27;CyL;30-39;6113;8194;14307
2020-09-27;AV;40-49;581;757;1338
2020-09-27;SA;40-49;1197;1631;2828
2020-09-27;VA;40-49;1766;2407;4173
2020-09-27;BU;50-59;1249;1732;2981
2020-09-27;AV;60-69;483;550;1033
2020-09-27;BU;60-69;883;1000;1883
2020-09-27;PA;60-69;422;459;881
2020-09-27;SA;60-69;1029;1180;2209
2020-09-27;AV;70-79;359;404;763
2020-09-27;LE;70-79;804;750;1554
2020-09-27;SE;70-79;503;506;1009
2020-09-27;CyL;70-79;4617;4746;9363
2020-09-27;BU;>80;732;1327;2059
2020-09-27;SA;>80;982;1774;2756
2020-09-27;SE;>80;691;1147;1838
2020-09-27;SO;>80;438;773;1211
2020-09-27;CyL;>80;5742;10372;16114
2020-09-27;SA;0-9;570;568;1138
2020-09-27;SE;0-9;377;347;724
2020-09-27;ZA;0-9;261;254;515
2020-09-27;SA;10-19;511;526;1037
2020-09-27;SO;10-19;134;130;264
2020-09-27;CyL;10-19;3435;3322;6757
2020-09-27;BU;20-29;896;1033;1929
2020-09-27;VA;20-29;1117;1294;2411
2020-09-27;ZA;20-29;169;217;386
2020-09-27;CyL;20-29;4904;5874;10778
2020-09-27;LE;30-39;833;1282;2115
2020-09-27;SO;30-39;289;394;683
2020-09-27;VA;30-39;1360;1781;3141
2020-09-27;PA;40-49;527;625;1152
2020-09-27;LE;50-59;1137;1681;2818
2020-09-27;PA;50-59;516;666;1182
2020-09-27;VA;50-59;1480;2094;3574
2020-09-27;ZA;50-59;379;540;919
2020-09-27;ZA;60-69;332;374;706
2020-09-27;PA;70-79;294;305;599
2020-09-27;SA;70-79;726;802;1528
2020-09-27;SO;70-79;229;210;439
2020-09-27;ZA;70-79;237;230;467
2020-09-27;LE;>80;911;1652;2563
2020-09-27;AV;0-9;226;201;427
2020-09-27;PA;0-9;185;156;341
2020-09-27;PA;10-19;222;201;423
2020-09-27;SE;10-19;294;277;571
2020-09-27;AV;20-29;269;329;598
2020-09-27;LE;20-29;682;809;1491
2020-09-27;PA;20-29;333;338;671
2020-09-27;SA;20-29;805;1000;1805
2020-09-27;SO;20-29;241;306;547
2020-09-27;AV;30-39;395;536;931
2020-09-27;BU;30-39;1108;1359;2467
2020-09-27;PA;30-39;387;476;863
2020-09-27;SA;30-39;972;1335;2307
2020-09-27;SE;30-39;533;712;1245
2020-09-27;ZA;30-39;236;319;555
2020-09-27;BU;40-49;1453;1734;3187
2020-09-27;LE;40-49;1204;1768;2972
2020-09-27;SE;40-49;766;1072;1838
2020-09-27;SO;40-49;414;591;1005
2020-09-27;ZA;40-49;321;479;800
2020-09-27;CyL;40-49;8229;11064;19293
2020-09-27;AV;50-59;523;825;1348
2020-09-27;SA;50-59;1364;1949;3313
2020-09-27;SE;50-59;903;1347;2250
2020-09-27;SO;50-59;438;685;1123
2020-09-27;CyL;50-59;7989;11519;19508
2020-09-27;LE;60-69;990;1208;2198
2020-09-27;SE;60-69;754;820;1574
2020-09-27;SO;60-69;334;405;739
2020-09-27;VA;60-69;1148;1431;2579
2020-09-27;CyL;60-69;6375;7427;13802
2020-09-27;BU;70-79;598;609;1207
2020-09-27;VA;70-79;867;930;1797
2020-09-27;AV;>80;485;826;1311
2020-09-27;PA;>80;294;557;851
2020-09-27;VA;>80;883;1765;2648
2020-09-27;ZA;>80;326;551;877
2020-09-24;AV;0-9;220;199;419
2020-09-24;PA;0-9;178;151;329
2020-09-24;ZA;0-9;259;250;509
2020-09-24;CyL;0-9;3782;3337;7119
2020-09-24;LE;10-19;450;444;894
2020-09-24;SE;10-19;283;264;547
2020-09-24;SO;10-19;131;130;261
2020-09-24;CyL;10-19;3324;3203;6527
2020-09-24;AV;20-29;263;322;585
2020-09-24;LE;20-29;665;790;1455
2020-09-24;SA;20-29;796;991;1787
2020-09-24;SO;20-29;233;303;536
2020-09-24;BU;30-39;1086;1337;2423
2020-09-24;LE;30-39;821;1259;2080
2020-09-24;ZA;30-39;230;312;542
2020-09-24;CyL;30-39;6001;8056;14057
2020-09-24;AV;40-49;568;749;1317
2020-09-24;BU;40-49;1432;1720;3152
2020-09-24;SA;40-49;1175;1606;2781
2020-09-24;AV;50-59;515;820;1335
2020-09-24;PA;50-59;508;649;1157
2020-09-24;SA;50-59;1334;1927;3261
2020-09-24;SE;50-59;898;1339;2237
2020-09-24;ZA;50-59;370;528;898
2020-09-24;CyL;50-59;7871;11388;19259
2020-09-24;BU;60-69;866;986;1852
2020-09-24;SA;60-69;1009;1164;2173
2020-09-24;VA;60-69;1115;1399;2514
2020-09-24;CyL;60-69;6248;7315;13563
2020-09-24;LE;70-79;796;743;1539
2020-09-24;SE;70-79;495;501;996
2020-09-24;SO;70-79;227;208;435
2020-09-24;VA;70-79;829;895;1724
2020-09-24;ZA;70-79;228;222;450
2020-09-24;BU;>80;725;1309;2034
2020-09-24;LE;>80;902;1636;2538
2020-09-24;SE;>80;687;1136;1823
2020-09-24;CyL;>80;5667;10243;15910
2020-09-24;SO;0-9;150;129;279
2020-09-24;VA;0-9;928;774;1702
2020-09-24;BU;10-19;629;550;1179
2020-09-24;PA;10-19;213;191;404
2020-09-24;VA;10-19;775;772;1547
2020-09-24;ZA;10-19;146;145;291
2020-09-24;PA;20-29;323;326;649
2020-09-24;PA;30-39;376;463;839
2020-09-24;SO;30-39;286;393;679
2020-09-24;VA;30-39;1325;1746;3071
2020-09-24;LE;40-49;1182;1735;2917
2020-09-24;PA;40-49;517;613;1130
2020-09-24;SE;40-49;758;1067;1825
2020-09-24;ZA;40-49;314;470;784
2020-09-24;BU;50-59;1230;1718;2948
2020-09-24;LE;50-59;1125;1663;2788
2020-09-24;SO;50-59;432;682;1114
2020-09-24;VA;50-59;1459;2062;3521
2020-09-24;PA;60-69;410;449;859
2020-09-24;ZA;60-69;325;367;692
2020-09-24;AV;70-79;355;401;756
2020-09-24;BU;70-79;592;600;1192
2020-09-24;PA;70-79;291;301;592
2020-09-24;CyL;70-79;4525;4660;9185
2020-09-24;AV;>80;484;821;1305
2020-09-24;SA;>80;969;1765;2734
2020-09-24;SO;>80;429;762;1191
2020-09-24;VA;>80;858;1722;2580
2020-09-24;ZA;>80;322;540;862
2020-09-24;BU;0-9;640;532;1172
2020-09-24;LE;0-9;488;414;902
2020-09-24;SA;0-9;558;555;1113
2020-09-24;SE;0-9;361;333;694
2020-09-24;AV;10-19;200;195;395
2020-09-24;SA;10-19;497;512;1009
2020-09-24;BU;20-29;882;1008;1890
2020-09-24;SE;20-29;386;538;924
2020-09-24;VA;20-29;1093;1260;2353
2020-09-24;ZA;20-29;162;209;371
2020-09-24;CyL;20-29;4803;5747;10550
2020-09-24;AV;30-39;388;528;916
2020-09-24;SA;30-39;961;1317;2278
2020-09-24;SE;30-39;528;701;1229
2020-09-24;SO;40-49;407;586;993
2020-09-24;VA;40-49;1722;2364;4086
2020-09-24;CyL;40-49;8075;10910;18985
2020-09-24;AV;60-69;476;544;1020
2020-09-24;LE;60-69;973;1191;2164
2020-09-24;SE;60-69;742;812;1554
2020-09-24;SO;60-69;332;403;735
2020-09-24;SA;70-79;712;789;1501
2020-09-24;PA;>80;291;552;843
2020-09-23;AV;0-9;215;191;406
2020-09-23;PA;0-9;175;150;325
2020-09-23;SO;0-9;147;128;275
2020-09-23;ZA;0-9;257;247;504
2020-09-23;SA;10-19;482;496;978
2020-09-23;AV;20-29;261;321;582
2020-09-23;BU;20-29;871;999;1870
2020-09-23;SA;20-29;787;981;1768
2020-09-23;ZA;20-29;159;207;366
2020-09-23;CyL;20-29;4749;5682;10431
2020-09-23;PA;30-39;373;459;832
2020-09-23;SA;30-39;956;1302;2258
2020-09-23;VA;30-39;1313;1733;3046
2020-09-23;CyL;30-39;5944;7986;13930
2020-09-23;AV;40-49;562;745;1307
2020-09-23;BU;40-49;1421;1706;3127
2020-09-23;LE;40-49;1166;1716;2882
2020-09-23;SA;40-49;1164;1589;2753
2020-09-23;SO;40-49;407;584;991
2020-09-23;CyL;40-49;8002;10816;18818
2020-09-23;AV;50-59;511;817;1328
2020-09-23;LE;50-59;1115;1647;2762
2020-09-23;SA;50-59;1323;1910;3233
2020-09-23;PA;60-69;408;447;855
2020-09-23;SE;60-69;732;806;1538
2020-09-23;ZA;60-69;321;360;681
2020-09-23;PA;70-79;288;299;587
2020-09-23;SE;70-79;495;500;995
2020-09-23;VA;70-79;815;887;1702
2020-09-23;ZA;70-79;225;215;440
2020-09-23;SE;>80;685;1133;1818
2020-09-23;ZA;>80;317;534;851
2020-09-23;LE;0-9;477;408;885
2020-09-23;SE;0-9;357;327;684
2020-09-23;VA;0-9;914;763;1677
2020-09-23;CyL;0-9;3720;3281;7001
2020-09-23;LE;10-19;436;433;869
2020-09-23;PA;10-19;210;190;400
2020-09-23;SE;10-19;280;260;540
2020-09-23;VA;10-19;767;758;1525
2020-09-23;ZA;10-19;141;143;284
2020-09-23;CyL;10-19;3259;3138;6397
2020-09-23;PA;20-29;320;321;641
2020-09-23;SO;20-29;231;303;534
2020-09-23;AV;30-39;380;520;900
2020-09-23;LE;30-39;810;1251;2061
2020-09-23;ZA;30-39;226;308;534
2020-09-23;PA;40-49;512;605;1117
2020-09-23;SE;40-49;753;1064;1817
2020-09-23;ZA;40-49;310;466;776
2020-09-23;SO;50-59;428;681;1109
2020-09-23;ZA;50-59;362;523;885
2020-09-23;CyL;50-59;7792;11316;19108
2020-09-23;LE;60-69;964;1180;2144
2020-09-23;CyL;60-69;6188;7254;13442
2020-09-23;LE;70-79;787;733;1520
2020-09-23;SA;70-79;702;783;1485
2020-09-23;SO;70-79;227;206;433
2020-09-23;AV;>80;482;819;1301
2020-09-23;BU;>80;723;1306;2029
2020-09-23;LE;>80;888;1603;2491
2020-09-23;CyL;>80;5633;10166;15799
2020-09-23;BU;0-9;632;522;1154
2020-09-23;SA;0-9;546;545;1091
2020-09-23;AV;10-19;196;188;384
2020-09-23;BU;10-19;619;542;1161
2020-09-23;SO;10-19;128;128;256
2020-09-23;LE;20-29;656;766;1422
2020-09-23;SE;20-29;384;536;920
2020-09-23;VA;20-29;1080;1248;2328
2020-09-23;BU;30-39;1073;1320;2393
2020-09-23;SE;30-39;528;700;1228
2020-09-23;SO;30-39;285;393;678
2020-09-23;VA;40-49;1707;2341;4048
2020-09-23;BU;50-59;1215;1708;2923
2020-09-23;PA;50-59;503;645;1148
2020-09-23;SE;50-59;897;1337;2234
2020-09-23;VA;50-59;1438;2048;3486
2020-09-23;AV;60-69;474;541;1015
2020-09-23;BU;60-69;858;977;1835
2020-09-23;SA;60-69;998;1157;2155
2020-09-23;SO;60-69;331;400;731
2020-09-23;VA;60-69;1102;1386;2488
2020-09-23;AV;70-79;353;395;748
2020-09-23;BU;70-79;589;596;1185
2020-09-23;CyL;70-79;4481;4614;9095
2020-09-23;PA;>80;291;551;842
2020-09-23;SA;>80;968;1757;2725
2020-09-23;SO;>80;426;753;1179
2020-09-23;VA;>80;853;1710;2563
2020-09-22;LE;0-9;461;405;866
2020-09-22;PA;0-9;171;147;318
2020-09-22;SE;0-9;345;322;667
2020-09-22;SA;10-19;476;485;961
2020-09-22;VA;10-19;753;740;1493
2020-09-22;AV;20-29;259;316;575
2020-09-22;BU;30-39;1061;1305;2366
2020-09-22;SO;30-39;285;392;677
2020-09-22;ZA;30-39;224;302;526
2020-09-22;BU;40-49;1404;1696;3100
2020-09-22;SE;40-49;747;1060;1807
2020-09-22;ZA;40-49;305;458;763
2020-09-22;CyL;40-49;7904;10733;18637
2020-09-22;PA;50-59;500;640;1140
2020-09-22;SO;50-59;425;681;1106
2020-09-22;ZA;50-59;354;517;871
2020-09-22;BU;60-69;844;971;1815
2020-09-22;PA;60-69;408;440;848
2020-09-22;SA;60-69;994;1154;2148
2020-09-22;ZA;60-69;318;352;670
2020-09-22;CyL;60-69;6141;7195;13336
2020-09-22;PA;70-79;287;299;586
2020-09-22;SE;70-79;493;500;993
2020-09-22;VA;70-79;803;869;1672
2020-09-22;AV;>80;480;818;1298
2020-09-22;BU;>80;715;1298;2013
2020-09-22;PA;>80;284;548;832
2020-09-22;SO;>80;426;753;1179
2020-09-22;VA;>80;849;1696;2545
2020-09-22;ZA;>80;316;528;844
2020-09-22;AV;0-9;213;184;397
2020-09-22;LE;10-19;426;419;845
2020-09-22;SE;10-19;275;251;526
2020-09-22;BU;20-29;864;986;1850
2020-09-22;LE;20-29;644;758;1402
2020-09-22;PA;20-29;316;315;631
2020-09-22;SE;20-29;381;533;914
2020-09-22;VA;20-29;1064;1231;2295
2020-09-22;CyL;20-29;4688;5613;10301
2020-09-22;AV;30-39;377;518;895
2020-09-22;SA;30-39;951;1292;2243
2020-09-22;SE;30-39;523;695;1218
2020-09-22;CyL;30-39;5890;7906;13796
2020-09-22;PA;40-49;504;594;1098
2020-09-22;SO;40-49;405;579;984
2020-09-22;VA;40-49;1677;2326;4003
2020-09-22;BU;50-59;1203;1697;2900
2020-09-22;LE;50-59;1100;1634;2734
2020-09-22;SA;50-59;1319;1901;3220
2020-09-22;AV;60-69;469;537;1006
2020-09-22;LE;60-69;957;1173;2130
2020-09-22;SE;60-69;731;803;1534
2020-09-22;LE;70-79;777;723;1500
2020-09-22;SA;70-79;697;777;1474
2020-09-22;ZA;70-79;221;214;435
2020-09-22;CyL;70-79;4438;4571;9009
2020-09-22;SA;>80;963;1752;2715
2020-09-22;CyL;>80;5604;10124;15728
2020-09-22;BU;0-9;618;514;1132
2020-09-22;SA;0-9;531;534;1065
2020-09-22;SO;0-9;148;126;274
2020-09-22;VA;0-9;903;752;1655
2020-09-22;ZA;0-9;257;247;504
2020-09-22;CyL;0-9;3647;3231;6878
2020-09-22;AV;10-19;193;184;377
2020-09-22;BU;10-19;595;530;1125
2020-09-22;PA;10-19;206;185;391
2020-09-22;SO;10-19;127;127;254
2020-09-22;ZA;10-19;136;138;274
2020-09-22;CyL;10-19;3187;3059;6246
2020-09-22;SA;20-29;778;972;1750
2020-09-22;SO;20-29;228;299;527
2020-09-22;ZA;20-29;154;203;357
2020-09-22;LE;30-39;807;1236;2043
2020-09-22;PA;30-39;367;453;820
2020-09-22;VA;30-39;1295;1713;3008
2020-09-22;AV;40-49;559;739;1298
2020-09-22;LE;40-49;1151;1702;2853
2020-09-22;SA;40-49;1152;1579;2731
2020-09-22;AV;50-59;510;811;1321
2020-09-22;SE;50-59;892;1331;2223
2020-09-22;VA;50-59;1418;2030;3448
2020-09-22;CyL;50-59;7721;11242;18963
2020-09-22;SO;60-69;331;399;730
2020-09-22;VA;60-69;1089;1366;2455
2020-09-22;AV;70-79;349;392;741
2020-09-22;BU;70-79;585;591;1176
2020-09-22;SO;70-79;226;206;432
2020-09-22;LE;>80;887;1600;2487
2020-09-22;SE;>80;684;1131;1815
2020-09-21;AV;0-9;211;184;395
2020-09-21;BU;0-9;595;509;1104
2020-09-21;SA;0-9;519;523;1042
2020-09-21;CyL;0-9;3574;3184;6758
2020-09-21;AV;10-19;191;182;373
2020-09-21;LE;10-19;416;401;817
2020-09-21;PA;10-19;204;183;387
2020-09-21;AV;20-29;257;312;569
2020-09-21;BU;30-39;1054;1294;2348
2020-09-21;LE;30-39;799;1218;2017
2020-09-21;PA;30-39;365;452;817
2020-09-21;SA;30-39;941;1276;2217
2020-09-21;SO;30-39;283;391;674
2020-09-21;CyL;30-39;5839;7842;13681
2020-09-21;AV;40-49;558;737;1295
2020-09-21;PA;40-49;502;591;1093
2020-09-21;ZA;40-49;303;451;754
2020-09-21;CyL;40-49;7841;10658;18499
2020-09-21;AV;50-59;506;807;1313
2020-09-21;BU;50-59;1192;1685;2877
2020-09-21;SO;50-59;425;679;1104
2020-09-21;LE;60-69;947;1163;2110
2020-09-21;SA;60-69;983;1144;2127
2020-09-21;SE;60-69;724;800;1524
2020-09-21;LE;70-79;773;717;1490
2020-09-21;PA;70-79;287;298;585
2020-09-21;CyL;70-79;4410;4536;8946
2020-09-21;BU;>80;711;1294;2005
2020-09-21;LE;>80;884;1596;2480
2020-09-21;SA;>80;960;1744;2704
2020-09-21;SE;>80;683;1127;1810
2020-09-21;CyL;>80;5578;10083;15661
2020-09-21;LE;0-9;448;391;839
2020-09-21;PA;0-9;171;145;316
2020-09-21;SE;0-9;345;319;664
2020-09-21;SO;0-9;148;125;273
2020-09-21;VA;0-9;885;742;1627
2020-09-21;ZA;0-9;252;246;498
2020-09-21;BU;10-19;584;526;1110
2020-09-21;SA;10-19;469;476;945
2020-09-21;SO;10-19;126;126;252
2020-09-21;VA;10-19;733;725;1458
2020-09-21;ZA;10-19;135;137;272
2020-09-21;CyL;10-19;3127;3005;6132
2020-09-21;PA;20-29;312;312;624
2020-09-21;SA;20-29;769;960;1729
2020-09-21;SO;20-29;228;297;525
2020-09-21;VA;30-39;1281;1700;2981
2020-09-21;ZA;30-39;223;300;523
2020-09-21;BU;40-49;1394;1687;3081
2020-09-21;LE;40-49;1139;1687;2826
2020-09-21;SE;40-49;743;1055;1798
2020-09-21;VA;40-49;1658;2308;3966
2020-09-21;LE;50-59;1090;1622;2712
2020-09-21;SA;50-59;1315;1889;3204
2020-09-21;SE;50-59;888;1326;2214
2020-09-21;PA;60-69;406;437;843
2020-09-21;SA;70-79;687;766;1453
2020-09-21;VA;70-79;797;864;1661
2020-09-21;AV;>80;478;815;1293
2020-09-21;PA;>80;281;544;825
2020-09-21;ZA;>80;313;521;834
2020-09-21;SE;10-19;269;249;518
2020-09-21;BU;20-29;850;974;1824
2020-09-21;LE;20-29;638;742;1380
2020-09-21;SE;20-29;379;531;910
2020-09-21;VA;20-29;1051;1225;2276
2020-09-21;ZA;20-29;151;200;351
2020-09-21;CyL;20-29;4635;5553;10188
2020-09-21;AV;30-39;374;518;892
2020-09-21;SE;30-39;519;693;1212
2020-09-21;SA;40-49;1141;1566;2707
2020-09-21;SO;40-49;403;576;979
2020-09-21;PA;50-59;496;637;1133
2020-09-21;VA;50-59;1402;2017;3419
2020-09-21;ZA;50-59;351;513;864
2020-09-21;CyL;50-59;7665;11175;18840
2020-09-21;AV;60-69;465;534;999
2020-09-21;BU;60-69;836;965;1801
2020-09-21;SO;60-69;329;398;727
2020-09-21;VA;60-69;1078;1355;2433
2020-09-21;ZA;60-69;316;348;664
2020-09-21;CyL;60-69;6084;7144;13228
2020-09-21;AV;70-79;348;386;734
2020-09-21;BU;70-79;579;587;1166
2020-09-21;SE;70-79;492;498;990
2020-09-21;SO;70-79;226;206;432
2020-09-21;ZA;70-79;221;214;435
2020-09-21;SO;>80;425;752;1177
2020-09-21;VA;>80;843;1690;2533
2020-09-20;PA;0-9;172;151;323
2020-09-20;VA;0-9;920;781;1701
2020-09-20;ZA;0-9;253;246;499
2020-09-20;AV;10-19;193;179;372
2020-09-20;LE;10-19;417;398;815
2020-09-20;SE;10-19;279;258;537
2020-09-20;SO;10-19;127;129;256
2020-09-20;AV;20-29;255;313;568
2020-09-20;BU;30-39;1066;1324;2390
2020-09-20;CyL;30-39;5822;7865;13687
2020-09-20;BU;40-49;1419;1707;3126
2020-09-20;PA;40-49;505;601;1106
2020-09-20;SE;40-49;746;1069;1815
2020-09-20;SO;40-49;404;575;979
2020-09-20;ZA;40-49;302;455;757
2020-09-20;LE;50-59;1086;1615;2701
2020-09-20;SA;50-59;1295;1878;3173
2020-09-20;SO;50-59;425;676;1101
2020-09-20;ZA;50-59;346;507;853
2020-09-20;AV;60-69;464;535;999
2020-09-20;PA;60-69;404;443;847
2020-09-20;CyL;60-69;6047;7133;13180
2020-09-20;LE;70-79;765;718;1483
2020-09-20;SA;70-79;684;763;1447
2020-09-20;AV;>80;479;812;1291
2020-09-20;SO;>80;423;755;1178
2020-09-20;VA;>80;832;1657;2489
2020-09-20;BU;0-9;727;602;1329
2020-09-20;LE;0-9;483;421;904
2020-09-20;SE;0-9;369;355;724
2020-09-20;BU;10-19;604;551;1155
2020-09-20;SA;10-19;464;459;923
2020-09-20;ZA;10-19;131;139;270
2020-09-20;LE;20-29;633;739;1372
2020-09-20;SO;20-29;231;300;531
2020-09-20;CyL;20-29;4609;5524;10133
2020-09-20;AV;30-39;377;518;895
2020-09-20;LE;30-39;791;1216;2007
2020-09-20;SE;30-39;524;696;1220
2020-09-20;SO;30-39;284;389;673
2020-09-20;VA;30-39;1269;1690;2959
2020-09-20;ZA;30-39;220;297;517
2020-09-20;AV;40-49;555;737;1292
2020-09-20;LE;40-49;1137;1686;2823
2020-09-20;VA;40-49;1639;2288;3927
2020-09-20;PA;50-59;503;651;1154
2020-09-20;SE;50-59;891;1334;2225
2020-09-20;VA;50-59;1392;1999;3391
2020-09-20;SA;60-69;969;1144;2113
2020-09-20;SE;60-69;724;800;1524
2020-09-20;SO;60-69;328;401;729
2020-09-20;VA;60-69;1079;1347;2426
2020-09-20;AV;70-79;348;386;734
2020-09-20;PA;70-79;288;303;591
2020-09-20;SO;70-79;224;205;429
2020-09-20;ZA;70-79;219;209;428
2020-09-20;CyL;70-79;4399;4514;8913
2020-09-20;SE;>80;691;1126;1817
2020-09-20;ZA;>80;309;510;819
2020-09-20;CyL;>80;5566;10004;15570
2020-09-20;AV;0-9;207;183;390
2020-09-20;SA;0-9;559;564;1123
2020-09-20;SO;0-9;153;129;282
2020-09-20;CyL;0-9;3843;3432;7275
2020-09-20;PA;10-19;203;186;389
2020-09-20;VA;10-19;729;713;1442
2020-09-20;CyL;10-19;3147;3012;6159
2020-09-20;BU;20-29;850;973;1823
2020-09-20;PA;20-29;318;313;631
2020-09-20;SA;20-29;748;949;1697
2020-09-20;SE;20-29;375;529;904
2020-09-20;VA;20-29;1043;1206;2249
2020-09-20;ZA;20-29;156;202;358
2020-09-20;PA;30-39;361;452;813
2020-09-20;SA;30-39;930;1283;2213
2020-09-20;SA;40-49;1144;1558;2702
2020-09-20;CyL;40-49;7851;10676;18527
2020-09-20;AV;50-59;505;805;1310
2020-09-20;BU;50-59;1194;1683;2877
2020-09-20;CyL;50-59;7637;11148;18785
2020-09-20;BU;60-69;834;964;1798
2020-09-20;LE;60-69;938;1156;2094
2020-09-20;ZA;60-69;307;343;650
2020-09-20;BU;70-79;580;584;1164
2020-09-20;SE;70-79;495;495;990
2020-09-20;VA;70-79;796;851;1647
2020-09-20;BU;>80;714;1300;2014
2020-09-20;LE;>80;874;1570;2444
2020-09-20;PA;>80;285;543;828
2020-09-20;SA;>80;959;1731;2690
2020-09-17;SE;0-9;347;326;673
2020-09-17;ZA;0-9;250;242;492
2020-09-17;VA;10-19;697;688;1385
2020-09-17;AV;20-29;238;304;542
2020-09-17;SE;20-29;365;518;883
2020-09-17;SO;20-29;228;297;525
2020-09-17;ZA;20-29;150;194;344
2020-09-17;BU;30-39;1048;1291;2339
2020-09-17;LE;30-39;766;1194;1960
2020-09-17;PA;30-39;345;435;780
2020-09-17;AV;40-49;545;728;1273
2020-09-17;LE;40-49;1119;1647;2766
2020-09-17;AV;50-59;491;787;1278
2020-09-17;BU;50-59;1179;1657;2836
2020-09-17;PA;50-59;480;634;1114
2020-09-17;BU;60-69;822;947;1769
2020-09-17;SA;60-69;951;1126;2077
2020-09-17;ZA;60-69;302;331;633
2020-09-17;CyL;60-69;5936;6997;12933
2020-09-17;CyL;70-79;4315;4450;8765
2020-09-17;BU;>80;706;1283;1989
2020-09-17;SA;>80;932;1690;2622
2020-09-17;CyL;>80;5460;9833;15293
2020-09-17;AV;0-9;201;178;379
2020-09-17;SO;0-9;146;123;269
2020-09-17;VA;0-9;878;748;1626
2020-09-17;BU;10-19;582;526;1108
2020-09-17;LE;10-19;401;382;783
2020-09-17;PA;10-19;195;179;374
2020-09-17;SA;10-19;444;442;886
2020-09-17;SO;10-19;123;124;247
2020-09-17;LE;20-29;607;713;1320
2020-09-17;PA;20-29;305;299;604
2020-09-17;VA;20-29;1014;1177;2191
2020-09-17;AV;30-39;370;510;880
2020-09-17;SA;30-39;904;1259;2163
2020-09-17;SE;30-39;511;689;1200
2020-09-17;SO;30-39;279;386;665
2020-09-17;VA;30-39;1247;1654;2901
2020-09-17;ZA;30-39;212;288;500
2020-09-17;SA;40-49;1119;1537;2656
2020-09-17;SE;40-49;737;1057;1794
2020-09-17;ZA;40-49;291;438;729
2020-09-17;CyL;50-59;7475;10970;18445
2020-09-17;AV;60-69;451;526;977
2020-09-17;LE;60-69;927;1136;2063
2020-09-17;PA;60-69;391;422;813
2020-09-17;SE;60-69;715;793;1508
2020-09-17;SO;60-69;325;399;724
2020-09-17;VA;60-69;1052;1317;2369
2020-09-17;AV;70-79;344;383;727
2020-09-17;SA;70-79;667;748;1415
2020-09-17;SE;70-79;492;495;987
2020-09-17;SO;70-79;222;201;423
2020-09-17;ZA;70-79;208;204;412
2020-09-17;SE;>80;688;1121;1809
2020-09-17;VA;>80;792;1604;2396
2020-09-17;ZA;>80;296;479;775
2020-09-17;BU;0-9;670;553;1223
2020-09-17;LE;0-9;451;391;842
2020-09-17;PA;0-9;159;140;299
2020-09-17;SA;0-9;539;545;1084
2020-09-17;CyL;0-9;3641;3246;6887
2020-09-17;AV;10-19;190;171;361
2020-09-17;SE;10-19;265;250;515
2020-09-17;ZA;10-19;130;135;265
2020-09-17;CyL;10-19;3027;2897;5924
2020-09-17;BU;20-29;829;954;1783
2020-09-17;SA;20-29;727;923;1650
2020-09-17;CyL;20-29;4463;5379;9842
2020-09-17;CyL;30-39;5682;7706;13388
2020-09-17;BU;40-49;1383;1674;3057
2020-09-17;PA;40-49;489;586;1075
2020-09-17;SO;40-49;395;569;964
2020-09-17;VA;40-49;1598;2252;3850
2020-09-17;CyL;40-49;7676;10488;18164
2020-09-17;LE;50-59;1065;1594;2659
2020-09-17;SA;50-59;1269;1844;3113
2020-09-17;SE;50-59;884;1324;2208
2020-09-17;SO;50-59;421;670;1091
2020-09-17;VA;50-59;1355;1961;3316
2020-09-17;ZA;50-59;331;499;830
2020-09-17;BU;70-79;569;573;1142
2020-09-17;LE;70-79;755;709;1464
2020-09-17;PA;70-79;280;298;578
2020-09-17;VA;70-79;778;839;1617
2020-09-17;AV;>80;476;803;1279
2020-09-17;LE;>80;866;1561;2427
2020-09-17;PA;>80;283;539;822
2020-09-17;SO;>80;421;753;1174
2020-09-16;LE;0-9;416;376;792
2020-09-16;SE;0-9;337;297;634
2020-09-16;SO;0-9;142;123;265
2020-09-16;VA;0-9;848;720;1568
2020-09-16;ZA;0-9;244;240;484
2020-09-16;BU;10-19;559;509;1068
2020-09-16;LE;10-19;388;373;761
2020-09-16;PA;10-19;183;173;356
2020-09-16;SE;10-19;260;249;509
2020-09-16;VA;10-19;676;666;1342
2020-09-16;CyL;10-19;2940;2817;5757
2020-09-16;PA;20-29;302;297;599
2020-09-16;SA;20-29;724;911;1635
2020-09-16;SE;20-29;359;515;874
2020-09-16;BU;30-39;1028;1275;2303
2020-09-16;SA;30-39;893;1247;2140
2020-09-16;VA;30-39;1233;1636;2869
2020-09-16;ZA;30-39;204;281;485
2020-09-16;AV;40-49;543;724;1267
2020-09-16;BU;40-49;1366;1654;3020
2020-09-16;PA;40-49;485;579;1064
2020-09-16;SO;40-49;393;568;961
2020-09-16;CyL;40-49;7599;10381;17980
2020-09-16;BU;50-59;1166;1641;2807
2020-09-16;LE;50-59;1059;1581;2640
2020-09-16;SE;50-59;879;1321;2200
2020-09-16;AV;60-69;450;524;974
2020-09-16;BU;60-69;814;939;1753
2020-09-16;SO;60-69;324;399;723
2020-09-16;CyL;60-69;5866;6943;12809
2020-09-16;BU;70-79;560;571;1131
2020-09-16;PA;70-79;278;296;574
2020-09-16;ZA;70-79;202;196;398
2020-09-16;AV;>80;475;803;1278
2020-09-16;BU;>80;704;1275;1979
2020-09-16;VA;>80;788;1599;2387
2020-09-16;CyL;>80;5415;9768;15183
2020-09-16;AV;0-9;199;174;373
2020-09-16;AV;10-19;190;169;359
2020-09-16;SA;10-19;436;428;864
2020-09-16;ZA;10-19;125;127;252
2020-09-16;AV;20-29;236;304;540
2020-09-16;BU;20-29;813;941;1754
2020-09-16;LE;20-29;602;706;1308
2020-09-16;SO;20-29;227;297;524
2020-09-16;VA;20-29;1000;1155;2155
2020-09-16;CyL;20-29;4407;5314;9721
2020-09-16;AV;30-39;367;508;875
2020-09-16;LE;30-39;753;1176;1929
2020-09-16;SE;30-39;511;685;1196
2020-09-16;SO;30-39;279;386;665
2020-09-16;LE;40-49;1110;1630;2740
2020-09-16;SA;40-49;1106;1526;2632
2020-09-16;VA;40-49;1579;2229;3808
2020-09-16;ZA;40-49;284;426;710
2020-09-16;PA;50-59;474;628;1102
2020-09-16;SA;50-59;1254;1835;3089
2020-09-16;SO;50-59;419;668;1087
2020-09-16;PA;60-69;388;418;806
2020-09-16;VA;60-69;1035;1298;2333
2020-09-16;ZA;60-69;286;324;610
2020-09-16;LE;70-79;751;705;1456
2020-09-16;SE;70-79;489;494;983
2020-09-16;CyL;70-79;4277;4410;8687
2020-09-16;SA;>80;926;1685;2611
2020-09-16;ZA;>80;268;442;710
2020-09-16;BU;0-9;618;495;1113
2020-09-16;PA;0-9;154;128;282
2020-09-16;SA;0-9;523;529;1052
2020-09-16;CyL;0-9;3481;3082;6563
2020-09-16;SO;10-19;123;123;246
2020-09-16;ZA;20-29;144;188;332
2020-09-16;PA;30-39;341;427;768
2020-09-16;CyL;30-39;5609;7621;13230
2020-09-16;SE;40-49;733;1045;1778
2020-09-16;AV;50-59;489;786;1275
2020-09-16;VA;50-59;1333;1945;3278
2020-09-16;ZA;50-59;322;489;811
2020-09-16;CyL;50-59;7395;10894;18289
2020-09-16;LE;60-69;918;1129;2047
2020-09-16;SA;60-69;942;1121;2063
2020-09-16;SE;60-69;709;791;1500
2020-09-16;AV;70-79;344;381;725
2020-09-16;SA;70-79;658;737;1395
2020-09-16;SO;70-79;221;200;421
2020-09-16;VA;70-79;774;830;1604
2020-09-16;LE;>80;863;1556;2419
2020-09-16;PA;>80;283;539;822
2020-09-16;SE;>80;687;1117;1804
2020-09-16;SO;>80;421;752;1173
2020-09-15;SA;0-9;509;510;1019
2020-09-15;ZA;0-9;243;240;483
2020-09-15;PA;10-19;182;169;351
2020-09-15;VA;10-19;666;652;1318
2020-09-15;PA;20-29;296;291;587
2020-09-15;SE;20-29;360;513;873
2020-09-15;VA;20-29;983;1139;2122
2020-09-15;CyL;20-29;4342;5243;9585
2020-09-15;SE;30-39;501;680;1181
2020-09-15;VA;30-39;1219;1606;2825
2020-09-15;AV;40-49;537;721;1258
2020-09-15;BU;50-59;1151;1633;2784
2020-09-15;SA;50-59;1244;1822;3066
2020-09-15;SE;50-59;873;1312;2185
2020-09-15;CyL;50-59;7321;10816;18137
2020-09-15;AV;60-69;446;524;970
2020-09-15;SA;60-69;935;1116;2051
2020-09-15;SO;60-69;320;395;715
2020-09-15;CyL;60-69;5809;6896;12705
2020-09-15;AV;70-79;342;381;723
2020-09-15;BU;70-79;558;566;1124
2020-09-15;LE;70-79;746;690;1436
2020-09-15;LE;0-9;397;363;760
2020-09-15;PA;0-9;152;123;275
2020-09-15;SO;0-9;141;120;261
2020-09-15;AV;10-19;187;166;353
2020-09-15;LE;10-19;376;366;742
2020-09-15;SE;10-19;259;240;499
2020-09-15;ZA;10-19;123;126;249
2020-09-15;AV;20-29;229;300;529
2020-09-15;BU;20-29;797;929;1726
2020-09-15;SA;20-29;719;902;1621
2020-09-15;SO;20-29;225;293;518
2020-09-15;AV;30-39;362;501;863
2020-09-15;LE;30-39;742;1157;1899
2020-09-15;PA;30-39;339;420;759
2020-09-15;SO;30-39;279;383;662
2020-09-15;ZA;30-39;201;278;479
2020-09-15;CyL;30-39;5543;7527;13070
2020-09-15;BU;40-49;1351;1639;2990
2020-09-15;SO;40-49;390;568;958
2020-09-15;ZA;40-49;282;423;705
2020-09-15;CyL;40-49;7526;10311;17837
2020-09-15;LE;50-59;1045;1569;2614
2020-09-15;SO;50-59;417;667;1084
2020-09-15;VA;50-59;1314;1926;3240
2020-09-15;BU;60-69;807;935;1742
2020-09-15;LE;60-69;903;1118;2021
2020-09-15;VA;60-69;1023;1287;2310
2020-09-15;SO;70-79;220;201;421
2020-09-15;ZA;70-79;200;193;393
2020-09-15;CyL;70-79;4244;4371;8615
2020-09-15;AV;>80;474;797;1271
2020-09-15;LE;>80;860;1550;2410
2020-09-15;PA;>80;279;535;814
2020-09-15;SO;>80;421;750;1171
2020-09-15;CyL;>80;5379;9708;15087
2020-09-15;AV;0-9;198;169;367
2020-09-15;BU;0-9;611;494;1105
2020-09-15;SE;0-9;327;295;622
2020-09-15;VA;0-9;820;706;1526
2020-09-15;CyL;0-9;3398;3020;6418
2020-09-15;BU;10-19;545;496;1041
2020-09-15;SA;10-19;428;424;852
2020-09-15;SO;10-19;118;122;240
2020-09-15;CyL;10-19;2884;2761;5645
2020-09-15;LE;20-29;588;691;1279
2020-09-15;ZA;20-29;145;185;330
2020-09-15;BU;30-39;1013;1261;2274
2020-09-15;SA;30-39;887;1241;2128
2020-09-15;LE;40-49;1095;1614;2709
2020-09-15;PA;40-49;478;577;1055
2020-09-15;SA;40-49;1099;1523;2622
2020-09-15;SE;40-49;727;1038;1765
2020-09-15;VA;40-49;1567;2208;3775
2020-09-15;AV;50-59;484;777;1261
2020-09-15;PA;50-59;473;622;1095
2020-09-15;ZA;50-59;320;488;808
2020-09-15;PA;60-69;383;412;795
2020-09-15;SE;60-69;708;790;1498
2020-09-15;ZA;60-69;284;319;603
2020-09-15;PA;70-79;276;292;568
2020-09-15;SA;70-79;656;735;1391
2020-09-15;SE;70-79;487;494;981
2020-09-15;VA;70-79;759;819;1578
2020-09-15;BU;>80;701;1271;1972
2020-09-15;SA;>80;919;1679;2598
2020-09-15;SE;>80;686;1114;1800
2020-09-15;VA;>80;773;1572;2345
2020-09-15;ZA;>80;266;440;706
2020-09-14;LE;0-9;384;353;737
2020-09-14;PA;0-9;147;122;269
2020-09-14;SA;0-9;492;499;991
2020-09-14;SO;0-9;136;115;251
2020-09-14;SA;10-19;424;423;847
2020-09-14;VA;10-19;645;631;1276
2020-09-14;LE;20-29;583;681;1264
2020-09-14;PA;20-29;288;285;573
2020-09-14;SO;20-29;224;289;513
2020-09-14;ZA;20-29;140;184;324
2020-09-14;BU;30-39;996;1250;2246
2020-09-14;PA;30-39;332;419;751
2020-09-14;SE;30-39;500;677;1177
2020-09-14;VA;30-39;1194;1577;2771
2020-09-14;PA;40-49;472;573;1045
2020-09-14;SA;40-49;1092;1518;2610
2020-09-14;SO;40-49;387;565;952
2020-09-14;ZA;40-49;281;418;699
2020-09-14;AV;50-59;483;773;1256
2020-09-14;LE;50-59;1036;1559;2595
2020-09-14;SE;50-59;872;1311;2183
2020-09-14;SO;50-59;415;662;1077
2020-09-14;BU;60-69;797;926;1723
2020-09-14;AV;70-79;341;381;722
2020-09-14;CyL;70-79;4205;4335;8540
2020-09-14;LE;>80;857;1537;2394
2020-09-14;SE;>80;683;1113;1796
2020-09-14;ZA;>80;264;430;694
2020-09-14;AV;0-9;196;167;363
2020-09-14;SE;0-9;323;289;612
2020-09-14;VA;0-9;797;681;1478
2020-09-14;CyL;0-9;3285;2921;6206
2020-09-14;PA;10-19;181;166;347
2020-09-14;ZA;10-19;121;125;246
2020-09-14;BU;20-29;785;920;1705
2020-09-14;SA;20-29;713;898;1611
2020-09-14;VA;20-29;954;1123;2077
2020-09-14;CyL;20-29;4271;5188;9459
2020-09-14;AV;30-39;360;494;854
2020-09-14;LE;30-39;739;1143;1882
2020-09-14;SA;30-39;884;1237;2121
2020-09-14;ZA;30-39;201;273;474
2020-09-14;AV;40-49;534;717;1251
2020-09-14;BU;40-49;1331;1627;2958
2020-09-14;CyL;40-49;7441;10226;17667
2020-09-14;SA;50-59;1239;1812;3051
2020-09-14;VA;50-59;1295;1903;3198
2020-09-14;AV;60-69;444;522;966
2020-09-14;LE;60-69;893;1111;2004
2020-09-14;SA;60-69;930;1112;2042
2020-09-14;SO;60-69;317;395;712
2020-09-14;VA;60-69;1004;1265;2269
2020-09-14;ZA;60-69;278;315;593
2020-09-14;CyL;60-69;5751;6842;12593
2020-09-14;SA;70-79;644;726;1370
2020-09-14;SE;70-79;485;491;976
2020-09-14;VA;70-79;748;808;1556
2020-09-14;ZA;70-79;200;191;391
2020-09-14;VA;>80;766;1558;2324
2020-09-14;CyL;>80;5345;9652;14997
2020-09-14;BU;0-9;567;456;1023
2020-09-14;ZA;0-9;243;239;482
2020-09-14;AV;10-19;186;164;350
2020-09-14;BU;10-19;526;483;1009
2020-09-14;LE;10-19;371;357;728
2020-09-14;SE;10-19;255;236;491
2020-09-14;SO;10-19;115;120;235
2020-09-14;CyL;10-19;2824;2705;5529
2020-09-14;AV;20-29;227;298;525
2020-09-14;SE;20-29;357;510;867
2020-09-14;SO;30-39;278;380;658
2020-09-14;CyL;30-39;5484;7450;12934
2020-09-14;LE;40-49;1088;1604;2692
2020-09-14;SE;40-49;717;1035;1752
2020-09-14;VA;40-49;1539;2169;3708
2020-09-14;BU;50-59;1141;1616;2757
2020-09-14;PA;50-59;466;619;1085
2020-09-14;ZA;50-59;317;484;801
2020-09-14;CyL;50-59;7264;10739;18003
2020-09-14;PA;60-69;382;411;793
2020-09-14;SE;60-69;706;785;1491
2020-09-14;BU;70-79;551;562;1113
2020-09-14;LE;70-79;743;685;1428
2020-09-14;PA;70-79;273;292;565
2020-09-14;SO;70-79;220;199;419
2020-09-14;AV;>80;472;796;1268
2020-09-14;BU;>80;699;1265;1964
2020-09-14;PA;>80;279;534;813
2020-09-14;SA;>80;904;1669;2573
2020-09-14;SO;>80;421;750;1171
2020-09-13;AV;0-9;196;166;362
2020-09-13;LE;0-9;376;335;711
2020-09-13;SA;0-9;462;475;937
2020-09-13;SE;0-9;303;272;575
2020-09-13;ZA;0-9;244;236;480
2020-09-13;CyL;0-9;3158;2809;5967
2020-09-13;BU;10-19;518;478;996
2020-09-13;SA;10-19;407;410;817
2020-09-13;SE;10-19;244;235;479
2020-09-13;ZA;10-19;121;124;245
2020-09-13;CyL;10-19;2758;2660;5418
2020-09-13;BU;20-29;778;915;1693
2020-09-13;LE;20-29;580;674;1254
2020-09-13;SO;20-29;218;287;505
2020-09-13;CyL;20-29;4216;5144;9360
2020-09-13;SA;30-39;873;1226;2099
2020-09-13;CyL;30-39;5423;7377;12800
2020-09-13;PA;40-49;463;564;1027
2020-09-13;SE;40-49;710;1029;1739
2020-09-13;BU;50-59;1133;1607;2740
2020-09-13;PA;50-59;457;613;1070
2020-09-13;SO;50-59;414;659;1073
2020-09-13;VA;50-59;1281;1891;3172
2020-09-13;ZA;50-59;316;481;797
2020-09-13;AV;60-69;443;519;962
2020-09-13;SO;60-69;315;392;707
2020-09-13;ZA;70-79;197;191;388
2020-09-13;AV;>80;471;793;1264
2020-09-13;LE;>80;854;1534;2388
2020-09-13;SA;>80;903;1660;2563
2020-09-13;VA;>80;763;1553;2316
2020-09-13;PA;0-9;134;114;248
2020-09-13;SO;0-9;133;115;248
2020-09-13;SO;10-19;112;119;231
2020-09-13;AV;20-29;226;297;523
2020-09-13;PA;20-29;282;281;563
2020-09-13;SO;30-39;275;380;655
2020-09-13;VA;30-39;1176;1554;2730
2020-09-13;AV;40-49;531;715;1246
2020-09-13;LE;40-49;1063;1591;2654
2020-09-13;SA;40-49;1084;1510;2594
2020-09-13;CyL;40-49;7357;10152;17509
2020-09-13;LE;50-59;1029;1546;2575
2020-09-13;SE;50-59;867;1308;2175
2020-09-13;BU;60-69;789;921;1710
2020-09-13;LE;60-69;889;1103;1992
2020-09-13;PA;60-69;376;407;783
2020-09-13;SE;60-69;706;783;1489
2020-09-13;ZA;60-69;275;312;587
2020-09-13;BU;70-79;551;560;1111
2020-09-13;PA;70-79;268;287;555
2020-09-13;SE;70-79;483;487;970
2020-09-13;SO;70-79;220;198;418
2020-09-13;VA;70-79;740;804;1544
2020-09-13;BU;>80;695;1263;1958
2020-09-13;SO;>80;420;750;1170
2020-09-13;CyL;>80;5329;9624;14953
2020-09-13;BU;0-9;528;430;958
2020-09-13;VA;0-9;782;666;1448
2020-09-13;AV;10-19;185;161;346
2020-09-13;LE;10-19;366;352;718
2020-09-13;PA;10-19;172;161;333
2020-09-13;VA;10-19;633;620;1253
2020-09-13;SA;20-29;705;890;1595
2020-09-13;SE;20-29;349;505;854
2020-09-13;VA;20-29;939;1113;2052
2020-09-13;ZA;20-29;139;182;321
2020-09-13;AV;30-39;358;490;848
2020-09-13;BU;30-39;991;1239;2230
2020-09-13;LE;30-39;731;1130;1861
2020-09-13;PA;30-39;329;414;743
2020-09-13;SE;30-39;490;671;1161
2020-09-13;ZA;30-39;200;273;473
2020-09-13;BU;40-49;1310;1619;2929
2020-09-13;SO;40-49;386;564;950
2020-09-13;VA;40-49;1530;2144;3674
2020-09-13;ZA;40-49;280;416;696
2020-09-13;AV;50-59;482;771;1253
2020-09-13;SA;50-59;1226;1796;3022
2020-09-13;CyL;50-59;7205;10672;17877
2020-09-13;SA;60-69;921;1100;2021
2020-09-13;VA;60-69;993;1254;2247
2020-09-13;CyL;60-69;5707;6791;12498
2020-09-13;AV;70-79;340;381;721
2020-09-13;LE;70-79;739;682;1421
2020-09-13;SA;70-79;641;723;1364
2020-09-13;CyL;70-79;4179;4313;8492
2020-09-13;PA;>80;278;531;809
2020-09-13;SE;>80;681;1110;1791
2020-09-13;ZA;>80;264;430;694
2020-09-10;AV;0-9;184;161;345
2020-09-10;SE;0-9;298;254;552
2020-09-10;SO;0-9;126;116;242
2020-09-10;CyL;0-9;3075;2717;5792
2020-09-10;AV;10-19;180;160;340
2020-09-10;SA;10-19;404;391;795
2020-09-10;VA;10-19;594;589;1183
2020-09-10;ZA;10-19;115;122;237
2020-09-10;BU;20-29;754;889;1643
2020-09-10;SA;20-29;687;868;1555
2020-09-10;SO;20-29;212;281;493
2020-09-10;CyL;20-29;4108;4993;9101
2020-09-10;BU;30-39;974;1216;2190
2020-09-10;SE;30-39;479;660;1139
2020-09-10;VA;30-39;1138;1522;2660
2020-09-10;CyL;30-39;5318;7239;12557
2020-09-10;BU;40-49;1290;1592;2882
2020-09-10;SE;40-49;701;1017;1718
2020-09-10;CyL;40-49;7196;9974;17170
2020-09-10;LE;60-69;867;1087;1954
2020-09-10;VA;60-69;958;1227;2185
2020-09-10;AV;70-79;337;372;709
2020-09-10;BU;70-79;546;553;1099
2020-09-10;CyL;70-79;4102;4230;8332
2020-09-10;VA;>80;749;1534;2283
2020-09-10;BU;0-9;526;414;940
2020-09-10;VA;0-9;759;645;1404
2020-09-10;ZA;0-9;241;235;476
2020-09-10;LE;10-19;337;334;671
2020-09-10;SE;10-19;230;230;460
2020-09-10;SO;10-19;111;117;228
2020-09-10;PA;20-29;270;267;537
2020-09-10;SE;20-29;349;493;842
2020-09-10;PA;30-39;322;402;724
2020-09-10;SA;30-39;868;1203;2071
2020-09-10;SO;30-39;270;376;646
2020-09-10;AV;40-49;524;708;1232
2020-09-10;PA;40-49;456;552;1008
2020-09-10;ZA;40-49;276;406;682
2020-09-10;AV;50-59;475;761;1236
2020-09-10;BU;50-59;1122;1573;2695
2020-09-10;SE;50-59;854;1291;2145
2020-09-10;SO;50-59;410;655;1065
2020-09-10;VA;50-59;1246;1830;3076
2020-09-10;AV;60-69;433;509;942
2020-09-10;BU;60-69;785;912;1697
2020-09-10;SA;60-69;905;1083;1988
2020-09-10;LE;70-79;728;667;1395
2020-09-10;PA;70-79;260;280;540
2020-09-10;SA;70-79;622;705;1327
2020-09-10;SO;70-79;218;196;414
2020-09-10;VA;70-79;719;785;1504
2020-09-10;AV;>80;458;777;1235
2020-09-10;BU;>80;690;1241;1931
2020-09-10;SE;>80;677;1106;1783
2020-09-10;SO;>80;422;744;1166
2020-09-10;ZA;>80;257;426;683
2020-09-10;LE;0-9;368;322;690
2020-09-10;PA;0-9;130;107;237
2020-09-10;SA;0-9;443;463;906
2020-09-10;BU;10-19;493;460;953
2020-09-10;PA;10-19;160;149;309
2020-09-10;CyL;10-19;2624;2552;5176
2020-09-10;AV;20-29;222;287;509
2020-09-10;LE;20-29;563;658;1221
2020-09-10;VA;20-29;912;1080;1992
2020-09-10;ZA;20-29;139;170;309
2020-09-10;AV;30-39;355;482;837
2020-09-10;LE;30-39;719;1109;1828
2020-09-10;ZA;30-39;193;269;462
2020-09-10;LE;40-49;1027;1561;2588
2020-09-10;SA;40-49;1058;1480;2538
2020-09-10;SO;40-49;378;559;937
2020-09-10;VA;40-49;1486;2099;3585
2020-09-10;LE;50-59;1008;1523;2531
2020-09-10;PA;50-59;443;601;1044
2020-09-10;SA;50-59;1205;1770;2975
2020-09-10;ZA;50-59;309;475;784
2020-09-10;CyL;50-59;7072;10479;17551
2020-09-10;PA;60-69;370;400;770
2020-09-10;SE;60-69;691;776;1467
2020-09-10;SO;60-69;310;385;695
2020-09-10;ZA;60-69;273;307;580
2020-09-10;CyL;60-69;5592;6686;12278
2020-09-10;SE;70-79;480;486;966
2020-09-10;ZA;70-79;192;186;378
2020-09-10;LE;>80;845;1525;2370
2020-09-10;PA;>80;271;525;796
2020-09-10;SA;>80;891;1632;2523
2020-09-10;CyL;>80;5260;9510;14770
2020-09-09;BU;0-9;509;396;905
2020-09-09;LE;0-9;358;315;673
2020-09-09;SA;0-9;434;453;887
2020-09-09;SO;0-9;125;113;238
2020-09-09;CyL;10-19;2562;2495;5057
2020-09-09;BU;20-29;747;881;1628
2020-09-09;PA;20-29;266;263;529
2020-09-09;SO;20-29;210;281;491
2020-09-09;VA;20-29;891;1062;1953
2020-09-09;CyL;20-29;4032;4929;8961
2020-09-09;SA;30-39;857;1196;2053
2020-09-09;SO;30-39;267;373;640
2020-09-09;CyL;30-39;5241;7171;12412
2020-09-09;LE;40-49;1018;1544;2562
2020-09-09;SE;40-49;700;1010;1710
2020-09-09;VA;40-49;1462;2063;3525
2020-09-09;PA;50-59;441;595;1036
2020-09-09;AV;60-69;430;508;938
2020-09-09;SA;60-69;893;1076;1969
2020-09-09;VA;60-69;945;1208;2153
2020-09-09;SE;>80;677;1103;1780
2020-09-09;SO;>80;421;742;1163
2020-09-09;AV;0-9;183;160;343
2020-09-09;BU;10-19;484;449;933
2020-09-09;SA;10-19;395;386;781
2020-09-09;SE;10-19;231;226;457
2020-09-09;SO;10-19;110;116;226
2020-09-09;ZA;10-19;114;119;233
2020-09-09;AV;20-29;221;286;507
2020-09-09;LE;20-29;543;651;1194
2020-09-09;SA;20-29;677;854;1531
2020-09-09;SE;20-29;345;487;832
2020-09-09;BU;30-39;952;1206;2158
2020-09-09;BU;40-49;1280;1580;2860
2020-09-09;SA;40-49;1051;1468;2519
2020-09-09;CyL;40-49;7130;9870;17000
2020-09-09;LE;50-59;998;1517;2515
2020-09-09;SE;50-59;849;1287;2136
2020-09-09;VA;50-59;1229;1802;3031
2020-09-09;BU;60-69;781;905;1686
2020-09-09;LE;60-69;852;1078;1930
2020-09-09;PA;60-69;367;399;766
2020-09-09;SE;60-69;687;775;1462
2020-09-09;SO;60-69;309;384;693
2020-09-09;BU;70-79;540;541;1081
2020-09-09;LE;70-79;722;663;1385
2020-09-09;SA;70-79;616;695;1311
2020-09-09;VA;70-79;710;779;1489
2020-09-09;AV;>80;457;774;1231
2020-09-09;LE;>80;839;1511;2350
2020-09-09;VA;>80;745;1532;2277
2020-09-09;ZA;>80;256;425;681
2020-09-09;PA;0-9;127;104;231
2020-09-09;SE;0-9;292;247;539
2020-09-09;VA;0-9;742;630;1372
2020-09-09;ZA;0-9;233;231;464
2020-09-09;CyL;0-9;3003;2649;5652
2020-09-09;AV;10-19;178;160;338
2020-09-09;LE;10-19;324;321;645
2020-09-09;PA;10-19;157;147;304
2020-09-09;VA;10-19;569;571;1140
2020-09-09;ZA;20-29;132;164;296
2020-09-09;AV;30-39;354;482;836
2020-09-09;LE;30-39;706;1095;1801
2020-09-09;PA;30-39;319;398;717
2020-09-09;SE;30-39;472;652;1124
2020-09-09;VA;30-39;1124;1505;2629
2020-09-09;ZA;30-39;190;264;454
2020-09-09;AV;40-49;521;703;1224
2020-09-09;PA;40-49;452;546;998
2020-09-09;SO;40-49;378;559;937
2020-09-09;ZA;40-49;268;397;665
2020-09-09;AV;50-59;474;760;1234
2020-09-09;BU;50-59;1113;1560;2673
2020-09-09;SA;50-59;1192;1759;2951
2020-09-09;SO;50-59;407;655;1062
2020-09-09;ZA;50-59;307;469;776
2020-09-09;CyL;50-59;7010;10404;17414
2020-09-09;ZA;60-69;269;301;570
2020-09-09;CyL;60-69;5533;6634;12167
2020-09-09;AV;70-79;337;368;705
2020-09-09;PA;70-79;260;280;540
2020-09-09;SE;70-79;479;485;964
2020-09-09;SO;70-79;216;195;411
2020-09-09;ZA;70-79;192;182;374
2020-09-09;CyL;70-79;4072;4188;8260
2020-09-09;BU;>80;681;1227;1908
2020-09-09;PA;>80;271;522;793
2020-09-09;SA;>80;883;1627;2510
2020-09-09;CyL;>80;5230;9463;14693
2020-09-08;SE;0-9;291;240;531
2020-09-08;SO;0-9;125;113;238
2020-09-08;ZA;0-9;233;231;464
2020-09-08;BU;20-29;741;875;1616
2020-09-08;LE;20-29;529;644;1173
2020-09-08;SA;20-29;669;852;1521
2020-09-08;VA;20-29;877;1046;1923
2020-09-08;PA;30-39;318;396;714
2020-09-08;BU;40-49;1269;1570;2839
2020-09-08;PA;40-49;445;545;990
2020-09-08;VA;40-49;1451;2049;3500
2020-09-08;ZA;40-49;268;395;663
2020-09-08;SA;50-59;1183;1750;2933
2020-09-08;SO;50-59;405;653;1058
2020-09-08;AV;60-69;425;504;929
2020-09-08;BU;60-69;767;899;1666
2020-09-08;PA;60-69;363;397;760
2020-09-08;VA;60-69;933;1197;2130
2020-09-08;BU;70-79;534;541;1075
2020-09-08;ZA;70-79;192;181;373
2020-09-08;AV;>80;456;771;1227
2020-09-08;PA;>80;270;518;788
2020-09-08;VA;>80;741;1524;2265
2020-09-08;BU;0-9;496;385;881
2020-09-08;LE;0-9;350;304;654
2020-09-08;PA;0-9;127;104;231
2020-09-08;SA;0-9;431;443;874
2020-09-08;AV;10-19;178;160;338
2020-09-08;LE;10-19;317;314;631
2020-09-08;PA;10-19;157;144;301
2020-09-08;SA;10-19;388;382;770
2020-09-08;SO;10-19;111;114;225
2020-09-08;VA;10-19;564;559;1123
2020-09-08;ZA;10-19;114;119;233
2020-09-08;CyL;10-19;2534;2455;4989
2020-09-08;PA;20-29;264;263;527
2020-09-08;SE;20-29;338;483;821
2020-09-08;SO;20-29;209;281;490
2020-09-08;CyL;20-29;3979;4890;8869
2020-09-08;AV;30-39;349;478;827
2020-09-08;LE;30-39;698;1086;1784
2020-09-08;SA;30-39;852;1193;2045
2020-09-08;SA;40-49;1046;1457;2503
2020-09-08;AV;50-59;473;756;1229
2020-09-08;LE;50-59;989;1505;2494
2020-09-08;PA;50-59;434;588;1022
2020-09-08;ZA;50-59;307;467;774
2020-09-08;CyL;50-59;6950;10349;17299
2020-09-08;LE;60-69;849;1067;1916
2020-09-08;SA;60-69;888;1074;1962
2020-09-08;SE;60-69;684;775;1459
2020-09-08;SO;60-69;309;382;691
2020-09-08;PA;70-79;257;278;535
2020-09-08;SE;70-79;474;483;957
2020-09-08;SA;>80;879;1619;2498
2020-09-08;SE;>80;677;1098;1775
2020-09-08;SO;>80;420;741;1161
2020-09-08;ZA;>80;255;422;677
2020-09-08;CyL;>80;5211;9420;14631
2020-09-08;AV;0-9;182;157;339
2020-09-08;VA;0-9;724;622;1346
2020-09-08;CyL;0-9;2959;2599;5558
2020-09-08;BU;10-19;477;441;918
2020-09-08;SE;10-19;228;222;450
2020-09-08;AV;20-29;219;283;502
2020-09-08;ZA;20-29;133;163;296
2020-09-08;BU;30-39;942;1200;2142
2020-09-08;SE;30-39;472;648;1120
2020-09-08;SO;30-39;267;371;638
2020-09-08;VA;30-39;1107;1496;2603
2020-09-08;ZA;30-39;191;264;455
2020-09-08;CyL;30-39;5196;7132;12328
2020-09-08;AV;40-49;520;699;1219
2020-09-08;LE;40-49;1007;1531;2538
2020-09-08;SE;40-49;693;1006;1699
2020-09-08;SO;40-49;374;556;930
2020-09-08;CyL;40-49;7073;9808;16881
2020-09-08;BU;50-59;1105;1555;2660
2020-09-08;SE;50-59;846;1284;2130
2020-09-08;VA;50-59;1208;1791;2999
2020-09-08;ZA;60-69;270;301;571
2020-09-08;CyL;60-69;5488;6596;12084
2020-09-08;AV;70-79;336;366;702
2020-09-08;LE;70-79;712;651;1363
2020-09-08;SA;70-79;614;690;1304
2020-09-08;SO;70-79;214;192;406
2020-09-08;VA;70-79;704;773;1477
2020-09-08;CyL;70-79;4037;4155;8192
2020-09-08;BU;>80;679;1228;1907
2020-09-08;LE;>80;834;1499;2333
2020-09-06;AV;0-9;180;149;329
2020-09-06;BU;0-9;468;372;840
2020-09-06;SA;0-9;423;435;858
2020-09-06;VA;0-9;714;617;1331
2020-09-06;ZA;0-9;227;229;456
2020-09-06;CyL;0-9;2889;2538;5427
2020-09-06;LE;10-19;308;299;607
2020-09-06;SE;10-19;226;221;447
2020-09-06;LE;20-29;514;629;1143
2020-09-06;PA;20-29;256;253;509
2020-09-06;SO;20-29;206;279;485
2020-09-06;VA;20-29;849;1028;1877
2020-09-06;AV;30-39;345;472;817
2020-09-06;BU;30-39;932;1183;2115
2020-09-06;PA;30-39;313;392;705
2020-09-06;CyL;30-39;5101;7044;12145
2020-09-06;SO;40-49;373;551;924
2020-09-06;VA;40-49;1424;2014;3438
2020-09-06;PA;50-59;420;578;998
2020-09-06;SA;50-59;1168;1743;2911
2020-09-06;SO;50-59;403;651;1054
2020-09-06;VA;50-59;1184;1763;2947
2020-09-06;CyL;50-59;6846;10252;17098
2020-09-06;AV;60-69;420;503;923
2020-09-06;PA;60-69;360;389;749
2020-09-06;SA;60-69;875;1072;1947
2020-09-06;SE;60-69;680;766;1446
2020-09-06;CyL;60-69;5402;6530;11932
2020-09-06;AV;70-79;329;362;691
2020-09-06;BU;70-79;527;535;1062
2020-09-06;ZA;70-79;187;178;365
2020-09-06;AV;>80;456;770;1226
2020-09-06;LE;>80;831;1495;2326
2020-09-06;PA;>80;267;517;784
2020-09-06;SE;0-9;280;230;510
2020-09-06;BU;10-19;472;432;904
2020-09-06;SA;10-19;376;377;753
2020-09-06;VA;10-19;556;545;1101
2020-09-06;ZA;10-19;105;116;221
2020-09-06;CyL;10-19;2480;2398;4878
2020-09-06;AV;20-29;216;280;496
2020-09-06;SE;20-29;332;472;804
2020-09-06;ZA;20-29;126;157;283
2020-09-06;CyL;20-29;3879;4805;8684
2020-09-06;LE;30-39;692;1069;1761
2020-09-06;SO;30-39;266;370;636
2020-09-06;PA;40-49;431;530;961
2020-09-06;BU;60-69;747;889;1636
2020-09-06;LE;60-69;840;1059;1899
2020-09-06;SO;60-69;306;379;685
2020-09-06;VA;60-69;911;1181;2092
2020-09-06;SE;70-79;471;476;947
2020-09-06;SO;70-79;211;191;402
2020-09-06;VA;70-79;693;760;1453
2020-09-06;SA;>80;873;1602;2475
2020-09-06;SE;>80;674;1086;1760
2020-09-06;LE;0-9;343;293;636
2020-09-06;PA;0-9;129;101;230
2020-09-06;SO;0-9;125;112;237
2020-09-06;AV;10-19;178;156;334
2020-09-06;PA;10-19;148;140;288
2020-09-06;SO;10-19;111;112;223
2020-09-06;BU;20-29;724;860;1584
2020-09-06;SA;20-29;656;847;1503
2020-09-06;SA;30-39;841;1182;2023
2020-09-06;SE;30-39;456;635;1091
2020-09-06;VA;30-39;1074;1481;2555
2020-09-06;ZA;30-39;182;260;442
2020-09-06;AV;40-49;515;692;1207
2020-09-06;BU;40-49;1259;1549;2808
2020-09-06;LE;40-49;990;1515;2505
2020-09-06;SA;40-49;1031;1447;2478
2020-09-06;SE;40-49;680;992;1672
2020-09-06;ZA;40-49;261;390;651
2020-09-06;CyL;40-49;6964;9680;16644
2020-09-06;AV;50-59;467;754;1221
2020-09-06;BU;50-59;1087;1541;2628
2020-09-06;LE;50-59;986;1493;2479
2020-09-06;SE;50-59;832;1272;2104
2020-09-06;ZA;50-59;299;457;756
2020-09-06;ZA;60-69;263;292;555
2020-09-06;LE;70-79;710;645;1355
2020-09-06;PA;70-79;250;267;517
2020-09-06;SA;70-79;604;676;1280
2020-09-06;CyL;70-79;3982;4090;8072
2020-09-06;BU;>80;672;1213;1885
2020-09-06;SO;>80;416;739;1155
2020-09-06;VA;>80;738;1511;2249
2020-09-06;ZA;>80;254;414;668
2020-09-06;CyL;>80;5181;9347;14528
2020-09-03;AV;0-9;174;146;320
2020-09-03;BU;0-9;463;355;818
2020-09-03;SA;0-9;413;421;834
2020-09-03;SO;0-9;122;111;233
2020-09-03;CyL;0-9;2830;2467;5297
2020-09-03;LE;10-19;293;288;581
2020-09-03;SO;10-19;107;108;215
2020-09-03;SO;20-29;204;275;479
2020-09-03;VA;20-29;814;992;1806
2020-09-03;ZA;20-29;121;151;272
2020-09-03;BU;30-39;920;1170;2090
2020-09-03;LE;30-39;677;1052;1729
2020-09-03;PA;30-39;308;383;691
2020-09-03;VA;30-39;1047;1451;2498
2020-09-03;CyL;30-39;4991;6926;11917
2020-09-03;LE;40-49;968;1499;2467
2020-09-03;PA;50-59;413;564;977
2020-09-03;SE;50-59;818;1260;2078
2020-09-03;VA;50-59;1142;1724;2866
2020-09-03;ZA;50-59;291;445;736
2020-09-03;CyL;50-59;6702;10098;16800
2020-09-03;AV;60-69;411;497;908
2020-09-03;SA;60-69;859;1055;1914
2020-09-03;SE;60-69;675;761;1436
2020-09-03;VA;60-69;892;1159;2051
2020-09-03;BU;70-79;518;534;1052
2020-09-03;LE;70-79;699;638;1337
2020-09-03;PA;70-79;241;260;501
2020-09-03;SA;70-79;596;664;1260
2020-09-03;VA;70-79;679;746;1425
2020-09-03;LE;>80;825;1486;2311
2020-09-03;VA;>80;725;1494;2219
2020-09-03;LE;0-9;335;288;623
2020-09-03;ZA;0-9;227;228;455
2020-09-03;BU;10-19;461;422;883
2020-09-03;PA;10-19;141;128;269
2020-09-03;SA;10-19;356;365;721
2020-09-03;SE;10-19;212;209;421
2020-09-03;AV;20-29;210;273;483
2020-09-03;BU;20-29;704;840;1544
2020-09-03;PA;20-29;243;242;485
2020-09-03;AV;30-39;338;461;799
2020-09-03;SA;30-39;822;1160;1982
2020-09-03;ZA;30-39;172;253;425
2020-09-03;AV;40-49;498;683;1181
2020-09-03;ZA;40-49;253;385;638
2020-09-03;CyL;40-49;6812;9532;16344
2020-09-03;AV;50-59;455;740;1195
2020-09-03;LE;50-59;972;1468;2440
2020-09-03;SO;50-59;398;651;1049
2020-09-03;BU;60-69;739;886;1625
2020-09-03;LE;60-69;824;1042;1866
2020-09-03;PA;60-69;351;380;731
2020-09-03;SO;60-69;302;375;677
2020-09-03;ZA;60-69;259;288;547
2020-09-03;AV;70-79;321;351;672
2020-09-03;SE;70-79;462;468;930
2020-09-03;SO;70-79;209;189;398
2020-09-03;CyL;70-79;3902;4023;7925
2020-09-03;AV;>80;453;768;1221
2020-09-03;SE;>80;671;1077;1748
2020-09-03;SO;>80;412;736;1148
2020-09-03;ZA;>80;250;409;659
2020-09-03;CyL;>80;5123;9275;14398
2020-09-03;PA;0-9;123;94;217
2020-09-03;SE;0-9;276;222;498
2020-09-03;VA;0-9;697;602;1299
2020-09-03;AV;10-19;170;146;316
2020-09-03;VA;10-19;536;525;1061
2020-09-03;ZA;10-19;102;115;217
2020-09-03;CyL;10-19;2378;2306;4684
2020-09-03;LE;20-29;497;615;1112
2020-09-03;SA;20-29;637;824;1461
2020-09-03;SE;20-29;321;465;786
2020-09-03;CyL;20-29;3751;4677;8428
2020-09-03;SE;30-39;446;629;1075
2020-09-03;SO;30-39;261;367;628
2020-09-03;BU;40-49;1245;1528;2773
2020-09-03;PA;40-49;419;517;936
2020-09-03;SA;40-49;1009;1426;2435
2020-09-03;SE;40-49;668;979;1647
2020-09-03;SO;40-49;370;546;916
2020-09-03;VA;40-49;1382;1969;3351
2020-09-03;BU;50-59;1065;1522;2587
2020-09-03;SA;50-59;1148;1724;2872
2020-09-03;CyL;60-69;5312;6443;11755
2020-09-03;ZA;70-79;177;173;350
2020-09-03;BU;>80;669;1206;1875
2020-09-03;PA;>80;261;510;771
2020-09-03;SA;>80;857;1589;2446
2020-09-02;AV;0-9;172;139;311
2020-09-02;CyL;0-9;2803;2421;5224
2020-09-02;SA;10-19;343;356;699
2020-09-02;SE;10-19;212;206;418
2020-09-02;SO;10-19;108;108;216
2020-09-02;VA;10-19;531;522;1053
2020-09-02;AV;30-39;335;457;792
2020-09-02;SE;30-39;442;622;1064
2020-09-02;PA;40-49;416;511;927
2020-09-02;SO;40-49;367;541;908
2020-09-02;VA;40-49;1368;1957;3325
2020-09-02;CyL;40-49;6766;9462;16228
2020-09-02;PA;50-59;407;560;967
2020-09-02;VA;50-59;1135;1715;2850
2020-09-02;CyL;50-59;6654;10027;16681
2020-09-02;AV;60-69;410;494;904
2020-09-02;PA;60-69;347;377;724
2020-09-02;VA;60-69;890;1155;2045
2020-09-02;AV;70-79;319;347;666
2020-09-02;BU;70-79;517;530;1047
2020-09-02;PA;70-79;240;259;499
2020-09-02;SO;70-79;207;187;394
2020-09-02;VA;70-79;675;735;1410
2020-09-02;CyL;70-79;3878;3983;7861
2020-09-02;AV;>80;451;766;1217
2020-09-02;BU;>80;664;1177;1841
2020-09-02;LE;>80;824;1481;2305
2020-09-02;SA;>80;852;1582;2434
2020-09-02;SE;>80;669;1072;1741
2020-09-02;SO;>80;412;734;1146
2020-09-02;PA;0-9;118;94;212
2020-09-02;VA;0-9;689;591;1280
2020-09-02;AV;10-19;166;143;309
2020-09-02;PA;10-19;138;128;266
2020-09-02;ZA;10-19;102;113;215
2020-09-02;CyL;10-19;2354;2280;4634
2020-09-02;AV;20-29;209;271;480
2020-09-02;LE;20-29;494;605;1099
2020-09-02;PA;20-29;237;242;479
2020-09-02;ZA;20-29;119;149;268
2020-09-02;CyL;20-29;3703;4628;8331
2020-09-02;LE;30-39;672;1043;1715
2020-09-02;PA;30-39;305;384;689
2020-09-02;SA;30-39;813;1155;1968
2020-09-02;SO;30-39;257;365;622
2020-09-02;VA;30-39;1035;1438;2473
2020-09-02;CyL;30-39;4944;6875;11819
2020-09-02;BU;40-49;1241;1524;2765
2020-09-02;LE;40-49;961;1494;2455
2020-09-02;SA;40-49;1003;1408;2411
2020-09-02;BU;50-59;1063;1516;2579
2020-09-02;SO;60-69;299;372;671
2020-09-02;ZA;60-69;256;286;542
2020-09-02;LE;70-79;696;632;1328
2020-09-02;SE;70-79;457;464;921
2020-09-02;ZA;70-79;176;174;350
2020-09-02;CyL;>80;5091;9184;14275
2020-09-02;BU;0-9;467;345;812
2020-09-02;LE;0-9;333;285;618
2020-09-02;SA;0-9;403;413;816
2020-09-02;SE;0-9;272;215;487
2020-09-02;SO;0-9;122;111;233
2020-09-02;ZA;0-9;227;228;455
2020-09-02;BU;10-19;461;419;880
2020-09-02;LE;10-19;293;285;578
2020-09-02;BU;20-29;694;837;1531
2020-09-02;SA;20-29;628;810;1438
2020-09-02;SE;20-29;317;460;777
2020-09-02;SO;20-29;203;273;476
2020-09-02;VA;20-29;802;981;1783
2020-09-02;BU;30-39;915;1166;2081
2020-09-02;ZA;30-39;170;245;415
2020-09-02;AV;40-49;495;674;1169
2020-09-02;SE;40-49;666;973;1639
2020-09-02;ZA;40-49;249;380;629
2020-09-02;AV;50-59;453;735;1188
2020-09-02;LE;50-59;967;1459;2426
2020-09-02;SA;50-59;1133;1704;2837
2020-09-02;SE;50-59;815;1254;2069
2020-09-02;SO;50-59;393;647;1040
2020-09-02;ZA;50-59;288;437;725
2020-09-02;BU;60-69;737;877;1614
2020-09-02;LE;60-69;822;1037;1859
2020-09-02;SA;60-69;851;1045;1896
2020-09-02;SE;60-69;668;761;1429
2020-09-02;CyL;60-69;5280;6404;11684
2020-09-02;SA;70-79;591;655;1246
2020-09-02;PA;>80;260;508;768
2020-09-02;VA;>80;718;1486;2204
2020-09-02;ZA;>80;241;378;619
2020-09-01;BU;0-9;451;337;788
2020-09-01;SA;0-9;399;407;806
2020-09-01;VA;0-9;677;584;1261
2020-09-01;ZA;0-9;226;226;452
2020-09-01;PA;10-19;138;126;264
2020-09-01;SA;10-19;340;356;696
2020-09-01;SO;10-19;107;108;215
2020-09-01;CyL;10-19;2324;2261;4585
2020-09-01;AV;20-29;209;271;480
2020-09-01;BU;20-29;682;822;1504
2020-09-01;LE;20-29;490;602;1092
2020-09-01;PA;20-29;234;241;475
2020-09-01;SA;20-29;617;804;1421
2020-09-01;SO;20-29;203;270;473
2020-09-01;VA;20-29;798;972;1770
2020-09-01;PA;40-49;415;509;924
2020-09-01;SO;40-49;366;541;907
2020-09-01;VA;40-49;1357;1943;3300
2020-09-01;CyL;40-49;6719;9418;16137
2020-09-01;SA;50-59;1125;1690;2815
2020-09-01;VA;50-59;1123;1703;2826
2020-09-01;BU;60-69;731;867;1598
2020-09-01;SO;60-69;299;370;669
2020-09-01;VA;60-69;887;1141;2028
2020-09-01;BU;70-79;509;520;1029
2020-09-01;CyL;70-79;3845;3955;7800
2020-09-01;AV;>80;450;765;1215
2020-09-01;SA;>80;846;1576;2422
2020-09-01;SO;>80;410;732;1142
2020-09-01;AV;0-9;170;139;309
2020-09-01;LE;0-9;329;282;611
2020-09-01;PA;0-9;118;92;210
2020-09-01;SE;0-9;267;214;481
2020-09-01;BU;10-19;453;417;870
2020-09-01;SE;10-19;209;205;414
2020-09-01;SE;20-29;313;458;771
2020-09-01;CyL;20-29;3665;4585;8250
2020-09-01;AV;30-39;334;456;790
2020-09-01;BU;30-39;913;1156;2069
2020-09-01;SE;30-39;436;616;1052
2020-09-01;SO;30-39;256;366;622
2020-09-01;BU;40-49;1231;1513;2744
2020-09-01;SE;40-49;659;969;1628
2020-09-01;ZA;40-49;246;377;623
2020-09-01;AV;50-59;450;732;1182
2020-09-01;BU;50-59;1055;1513;2568
2020-09-01;SO;50-59;389;643;1032
2020-09-01;AV;60-69;409;494;903
2020-09-01;PA;60-69;346;376;722
2020-09-01;SA;60-69;848;1041;1889
2020-09-01;ZA;60-69;254;286;540
2020-09-01;CyL;60-69;5258;6364;11622
2020-09-01;SO;70-79;206;187;393
2020-09-01;VA;70-79;667;732;1399
2020-09-01;ZA;70-79;175;174;349
2020-09-01;LE;>80;824;1472;2296
2020-09-01;SE;>80;670;1069;1739
2020-09-01;VA;>80;717;1479;2196
2020-09-01;ZA;>80;240;378;618
2020-09-01;CyL;>80;5071;9127;14198
2020-09-01;SO;0-9;122;110;232
2020-09-01;CyL;0-9;2759;2391;5150
2020-09-01;AV;10-19;166;140;306
2020-09-01;LE;10-19;293;284;577
2020-09-01;VA;10-19;520;515;1035
2020-09-01;ZA;10-19;98;110;208
2020-09-01;ZA;20-29;119;145;264
2020-09-01;LE;30-39;670;1040;1710
2020-09-01;PA;30-39;304;384;688
2020-09-01;SA;30-39;808;1148;1956
2020-09-01;VA;30-39;1020;1425;2445
2020-09-01;ZA;30-39;165;244;409
2020-09-01;CyL;30-39;4906;6835;11741
2020-09-01;AV;40-49;493;672;1165
2020-09-01;LE;40-49;956;1488;2444
2020-09-01;SA;40-49;996;1406;2402
2020-09-01;LE;50-59;965;1450;2415
2020-09-01;PA;50-59;406;560;966
2020-09-01;SE;50-59;813;1245;2058
2020-09-01;ZA;50-59;282;435;717
2020-09-01;CyL;50-59;6608;9971;16579
2020-09-01;LE;60-69;819;1034;1853
2020-09-01;SE;60-69;665;755;1420
2020-09-01;AV;70-79;317;344;661
2020-09-01;LE;70-79;694;628;1322
2020-09-01;PA;70-79;235;257;492
2020-09-01;SA;70-79;586;650;1236
2020-09-01;SE;70-79;456;463;919
2020-09-01;BU;>80;655;1149;1804
2020-09-01;PA;>80;259;507;766
2020-08-31;BU;0-9;443;334;777
2020-08-31;PA;0-9;118;94;212
2020-08-31;ZA;0-9;225;225;450
2020-08-31;CyL;0-9;2728;2383;5111
2020-08-31;BU;10-19;453;410;863
2020-08-31;SO;10-19;107;107;214
2020-08-31;AV;20-29;208;268;476
2020-08-31;SE;20-29;311;455;766
2020-08-31;SO;20-29;204;268;472
2020-08-31;PA;30-39;306;381;687
2020-08-31;SE;30-39;431;608;1039
2020-08-31;SO;30-39;255;363;618
2020-08-31;VA;30-39;1014;1415;2429
2020-08-31;ZA;30-39;163;243;406
2020-08-31;CyL;30-39;4877;6787;11664
2020-08-31;LE;40-49;951;1479;2430
2020-08-31;PA;40-49;411;506;917
2020-08-31;SO;40-49;366;539;905
2020-08-31;BU;50-59;1045;1502;2547
2020-08-31;LE;50-59;956;1446;2402
2020-08-31;PA;50-59;401;554;955
2020-08-31;VA;50-59;1117;1691;2808
2020-08-31;ZA;50-59;279;435;714
2020-08-31;CyL;50-59;6565;9923;16488
2020-08-31;SA;60-69;843;1029;1872
2020-08-31;ZA;60-69;254;284;538
2020-08-31;BU;70-79;504;516;1020
2020-08-31;SE;70-79;453;464;917
2020-08-31;VA;70-79;664;727;1391
2020-08-31;AV;>80;449;765;1214
2020-08-31;BU;>80;654;1147;1801
2020-08-31;PA;>80;257;504;761
2020-08-31;SE;>80;668;1068;1736
2020-08-31;ZA;>80;239;377;616
2020-08-31;AV;0-9;170;139;309
2020-08-31;LE;0-9;326;282;608
2020-08-31;AV;10-19;166;139;305
2020-08-31;PA;10-19;136;124;260
2020-08-31;PA;20-29;231;239;470
2020-08-31;SA;20-29;603;792;1395
2020-08-31;VA;20-29;784;966;1750
2020-08-31;ZA;20-29;117;144;261
2020-08-31;AV;30-39;331;454;785
2020-08-31;BU;30-39;909;1151;2060
2020-08-31;AV;40-49;491;671;1162
2020-08-31;SA;40-49;990;1399;2389
2020-08-31;SE;40-49;659;961;1620
2020-08-31;VA;40-49;1351;1928;3279
2020-08-31;AV;50-59;449;730;1179
2020-08-31;LE;60-69;817;1034;1851
2020-08-31;PA;60-69;339;373;712
2020-08-31;VA;60-69;879;1132;2011
2020-08-31;AV;70-79;314;344;658
2020-08-31;PA;70-79;231;253;484
2020-08-31;SA;70-79;582;648;1230
2020-08-31;SO;70-79;206;186;392
2020-08-31;ZA;70-79;174;174;348
2020-08-31;CyL;70-79;3819;3937;7756
2020-08-31;LE;>80;822;1467;2289
2020-08-31;VA;>80;714;1478;2192
2020-08-31;SA;0-9;391;405;796
2020-08-31;SE;0-9;261;210;471
2020-08-31;SO;0-9;121;110;231
2020-08-31;VA;0-9;673;584;1257
2020-08-31;LE;10-19;291;278;569
2020-08-31;SA;10-19;336;348;684
2020-08-31;SE;10-19;201;200;401
2020-08-31;VA;10-19;512;507;1019
2020-08-31;ZA;10-19;98;109;207
2020-08-31;CyL;10-19;2300;2222;4522
2020-08-31;BU;20-29;673;810;1483
2020-08-31;LE;20-29;487;594;1081
2020-08-31;CyL;20-29;3618;4536;8154
2020-08-31;LE;30-39;669;1034;1703
2020-08-31;SA;30-39;799;1138;1937
2020-08-31;BU;40-49;1217;1505;2722
2020-08-31;ZA;40-49;245;373;618
2020-08-31;CyL;40-49;6681;9361;16042
2020-08-31;SA;50-59;1121;1681;2802
2020-08-31;SE;50-59;810;1246;2056
2020-08-31;SO;50-59;387;638;1025
2020-08-31;AV;60-69;409;492;901
2020-08-31;BU;60-69;723;857;1580
2020-08-31;SE;60-69;664;754;1418
2020-08-31;SO;60-69;297;370;667
2020-08-31;CyL;60-69;5225;6325;11550
2020-08-31;LE;70-79;691;625;1316
2020-08-31;SA;>80;843;1565;2408
2020-08-31;SO;>80;408;732;1140
2020-08-31;CyL;>80;5054;9103;14157
2020-08-30;AV;0-9;170;139;309
2020-08-30;BU;0-9;451;341;792
2020-08-30;LE;0-9;322;280;602
2020-08-30;SE;0-9;261;211;472
2020-08-30;VA;0-9;667;581;1248
2020-08-30;BU;10-19;449;412;861
2020-08-30;LE;10-19;290;275;565
2020-08-30;SE;10-19;198;199;397
2020-08-30;ZA;10-19;98;108;206
2020-08-30;AV;20-29;208;268;476
2020-08-30;PA;20-29;229;235;464
2020-08-30;SA;20-29;591;786;1377
2020-08-30;SO;20-29;201;266;467
2020-08-30;ZA;20-29;117;144;261
2020-08-30;SO;30-39;256;361;617
2020-08-30;LE;40-49;942;1463;2405
2020-08-30;PA;40-49;411;507;918
2020-08-30;SE;40-49;653;956;1609
2020-08-30;VA;40-49;1345;1909;3254
2020-08-30;ZA;40-49;245;373;618
2020-08-30;BU;50-59;1045;1502;2547
2020-08-30;SA;50-59;1114;1671;2785
2020-08-30;SO;50-59;387;637;1024
2020-08-30;VA;50-59;1107;1685;2792
2020-08-30;ZA;50-59;279;433;712
2020-08-30;BU;60-69;719;857;1576
2020-08-30;ZA;60-69;254;283;537
2020-08-30;BU;70-79;502;513;1015
2020-08-30;LE;70-79;683;620;1303
2020-08-30;SE;70-79;451;462;913
2020-08-30;ZA;70-79;174;173;347
2020-08-30;BU;>80;653;1147;1800
2020-08-30;PA;>80;256;504;760
2020-08-30;SA;>80;840;1559;2399
2020-08-30;CyL;>80;5044;9078;14122
2020-08-30;PA;0-9;118;92;210
2020-08-30;SA;0-9;392;400;792
2020-08-30;ZA;0-9;224;224;448
2020-08-30;CyL;0-9;2728;2378;5106
2020-08-30;AV;10-19;164;138;302
2020-08-30;SA;10-19;334;341;675
2020-08-30;VA;10-19;509;507;1016
2020-08-30;LE;20-29;481;588;1069
2020-08-30;SE;20-29;308;450;758
2020-08-30;VA;20-29;773;964;1737
2020-08-30;CyL;20-29;3571;4504;8075
2020-08-30;BU;30-39;902;1147;2049
2020-08-30;PA;30-39;304;382;686
2020-08-30;ZA;30-39;163;240;403
2020-08-30;CyL;30-39;4842;6745;11587
2020-08-30;AV;40-49;488;668;1156
2020-08-30;SA;40-49;976;1388;2364
2020-08-30;SO;40-49;365;537;902
2020-08-30;CyL;40-49;6635;9298;15933
2020-08-30;LE;60-69;815;1026;1841
2020-08-30;PA;60-69;335;372;707
2020-08-30;SE;60-69;662;748;1410
2020-08-30;VA;60-69;875;1124;1999
2020-08-30;PA;70-79;231;253;484
2020-08-30;AV;>80;448;765;1213
2020-08-30;LE;>80;821;1454;2275
2020-08-30;SE;>80;668;1068;1736
2020-08-30;ZA;>80;237;376;613
2020-08-30;SO;0-9;123;110;233
2020-08-30;PA;10-19;135;124;259
2020-08-30;SO;10-19;104;107;211
2020-08-30;CyL;10-19;2281;2211;4492
2020-08-30;BU;20-29;663;803;1466
2020-08-30;AV;30-39;330;451;781
2020-08-30;LE;30-39;664;1024;1688
2020-08-30;SA;30-39;788;1127;1915
2020-08-30;SE;30-39;428;605;1033
2020-08-30;VA;30-39;1007;1408;2415
2020-08-30;BU;40-49;1210;1497;2707
2020-08-30;AV;50-59;449;727;1176
2020-08-30;LE;50-59;951;1437;2388
2020-08-30;PA;50-59;400;552;952
2020-08-30;SE;50-59;807;1244;2051
2020-08-30;CyL;50-59;6539;9888;16427
2020-08-30;AV;60-69;410;490;900
2020-08-30;SA;60-69;836;1025;1861
2020-08-30;SO;60-69;296;369;665
2020-08-30;CyL;60-69;5202;6294;11496
2020-08-30;AV;70-79;312;345;657
2020-08-30;SA;70-79;584;644;1228
2020-08-30;SO;70-79;205;186;391
2020-08-30;VA;70-79;660;726;1386
2020-08-30;CyL;70-79;3802;3922;7724
2020-08-30;SO;>80;408;731;1139
2020-08-30;VA;>80;713;1474;2187
2020-08-27;ZA;0-9;222;223;445
2020-08-27;CyL;0-9;2647;2322;4969
2020-08-27;BU;10-19;436;403;839
2020-08-27;SE;10-19;193;192;385
2020-08-27;VA;10-19;481;475;956
2020-08-27;AV;20-29;206;259;465
2020-08-27;BU;20-29;653;791;1444
2020-08-27;PA;20-29;221;231;452
2020-08-27;SO;20-29;197;261;458
2020-08-27;LE;30-39;653;1010;1663
2020-08-27;VA;30-39;985;1378;2363
2020-08-27;ZA;30-39;161;238;399
2020-08-27;SE;40-49;652;955;1607
2020-08-27;SO;40-49;352;535;887
2020-08-27;CyL;40-49;6512;9163;15675
2020-08-27;BU;50-59;1037;1484;2521
2020-08-27;SO;50-59;384;630;1014
2020-08-27;ZA;50-59;275;423;698
2020-08-27;LE;60-69;802;1008;1810
2020-08-27;PA;60-69;333;373;706
2020-08-27;SE;60-69;655;739;1394
2020-08-27;LE;70-79;675;612;1287
2020-08-27;SA;70-79;571;629;1200
2020-08-27;SE;70-79;450;459;909
2020-08-27;SO;70-79;203;184;387
2020-08-27;CyL;70-79;3737;3844;7581
2020-08-27;AV;>80;442;758;1200
2020-08-27;SO;>80;406;722;1128
2020-08-27;ZA;>80;237;374;611
2020-08-27;CyL;>80;4984;8953;13937
2020-08-27;AV;0-9;165;136;301
2020-08-27;LE;0-9;314;276;590
2020-08-27;PA;0-9;118;93;211
2020-08-27;SE;0-9;253;201;454
2020-08-27;SO;0-9;120;106;226
2020-08-27;VA;0-9;628;559;1187
2020-08-27;LE;10-19;279;270;549
2020-08-27;LE;20-29;469;574;1043
2020-08-27;VA;20-29;722;916;1638
2020-08-27;PA;30-39;297;375;672
2020-08-27;SA;30-39;769;1098;1867
2020-08-27;SE;30-39;421;600;1021
2020-08-27;CyL;30-39;4744;6633;11377
2020-08-27;AV;40-49;475;664;1139
2020-08-27;VA;40-49;1314;1861;3175
2020-08-27;SE;50-59;800;1243;2043
2020-08-27;AV;60-69;404;481;885
2020-08-27;SO;60-69;291;367;658
2020-08-27;VA;60-69;847;1099;1946
2020-08-27;CyL;60-69;5119;6195;11314
2020-08-27;AV;70-79;304;336;640
2020-08-27;PA;70-79;227;243;470
2020-08-27;BU;>80;643;1137;1780
2020-08-27;SA;>80;828;1524;2352
2020-08-27;VA;>80;705;1441;2146
2020-08-27;BU;0-9;447;334;781
2020-08-27;SA;0-9;380;394;774
2020-08-27;AV;10-19;156;136;292
2020-08-27;PA;10-19;136;123;259
2020-08-27;SA;10-19;319;332;651
2020-08-27;SO;10-19;100;107;207
2020-08-27;ZA;10-19;98;101;199
2020-08-27;CyL;10-19;2198;2139;4337
2020-08-27;SA;20-29;576;758;1334
2020-08-27;SE;20-29;305;445;750
2020-08-27;ZA;20-29;114;140;254
2020-08-27;CyL;20-29;3463;4375;7838
2020-08-27;AV;30-39;324;443;767
2020-08-27;BU;30-39;883;1132;2015
2020-08-27;SO;30-39;251;359;610
2020-08-27;BU;40-49;1193;1480;2673
2020-08-27;LE;40-49;929;1440;2369
2020-08-27;PA;40-49;405;502;907
2020-08-27;SA;40-49;952;1360;2312
2020-08-27;ZA;40-49;240;366;606
2020-08-27;AV;50-59;441;719;1160
2020-08-27;LE;50-59;937;1412;2349
2020-08-27;PA;50-59;397;550;947
2020-08-27;SA;50-59;1096;1645;2741
2020-08-27;VA;50-59;1085;1640;2725
2020-08-27;CyL;50-59;6452;9746;16198
2020-08-27;BU;60-69;715;848;1563
2020-08-27;SA;60-69;823;1003;1826
2020-08-27;ZA;60-69;249;277;526
2020-08-27;BU;70-79;492;502;994
2020-08-27;VA;70-79;644;707;1351
2020-08-27;ZA;70-79;171;172;343
2020-08-27;LE;>80;807;1434;2241
2020-08-27;PA;>80;250;498;748
2020-08-27;SE;>80;666;1065;1731
2020-08-26;PA;0-9;117;88;205
2020-08-26;LE;10-19;271;265;536
2020-08-26;AV;20-29;204;256;460
2020-08-26;BU;20-29;650;786;1436
2020-08-26;SO;20-29;197;260;457
2020-08-26;VA;20-29;698;886;1584
2020-08-26;ZA;20-29;112;138;250
2020-08-26;AV;30-39;319;441;760
2020-08-26;PA;30-39;296;372;668
2020-08-26;PA;40-49;402;501;903
2020-08-26;SA;40-49;939;1353;2292
2020-08-26;SO;40-49;351;536;887
2020-08-26;SO;50-59;384;629;1013
2020-08-26;CyL;50-59;6414;9683;16097
2020-08-26;BU;60-69;713;841;1554
2020-08-26;SE;60-69;653;737;1390
2020-08-26;SO;60-69;290;366;656
2020-08-26;VA;60-69;844;1088;1932
2020-08-26;CyL;60-69;5093;6148;11241
2020-08-26;BU;70-79;489;501;990
2020-08-26;BU;>80;638;1125;1763
2020-08-26;SA;>80;823;1509;2332
2020-08-26;VA;>80;702;1433;2135
2020-08-26;CyL;>80;4961;8899;13860
2020-08-26;BU;0-9;439;322;761
2020-08-26;SE;0-9;248;195;443
2020-08-26;CyL;0-9;2610;2274;4884
2020-08-26;AV;10-19;155;132;287
2020-08-26;SE;10-19;191;192;383
2020-08-26;SO;10-19;99;107;206
2020-08-26;VA;10-19;467;457;924
2020-08-26;CyL;10-19;2150;2097;4247
2020-08-26;PA;20-29;216;229;445
2020-08-26;SE;20-29;306;439;745
2020-08-26;CyL;20-29;3410;4308;7718
2020-08-26;BU;30-39;876;1122;1998
2020-08-26;LE;30-39;642;1006;1648
2020-08-26;SA;30-39;766;1088;1854
2020-08-26;SO;30-39;251;358;609
2020-08-26;ZA;30-39;159;235;394
2020-08-26;CyL;30-39;4702;6584;11286
2020-08-26;AV;40-49;471;660;1131
2020-08-26;ZA;40-49;239;365;604
2020-08-26;CyL;40-49;6469;9107;15576
2020-08-26;LE;50-59;933;1405;2338
2020-08-26;VA;50-59;1074;1625;2699
2020-08-26;ZA;50-59;271;421;692
2020-08-26;AV;60-69;402;478;880
2020-08-26;SA;60-69;812;994;1806
2020-08-26;LE;70-79;673;610;1283
2020-08-26;PA;70-79;222;243;465
2020-08-26;SA;70-79;565;624;1189
2020-08-26;SE;70-79;450;456;906
2020-08-26;SO;70-79;203;184;387
2020-08-26;VA;70-79;635;705;1340
2020-08-26;PA;>80;246;486;732
2020-08-26;SE;>80;665;1064;1729
2020-08-26;ZA;>80;237;374;611
2020-08-26;AV;0-9;164;133;297
2020-08-26;LE;0-9;308;272;580
2020-08-26;SA;0-9;376;393;769
2020-08-26;SO;0-9;120;105;225
2020-08-26;VA;0-9;616;544;1160
2020-08-26;ZA;0-9;222;222;444
2020-08-26;BU;10-19;428;395;823
2020-08-26;PA;10-19;133;118;251
2020-08-26;SA;10-19;310;330;640
2020-08-26;ZA;10-19;96;101;197
2020-08-26;LE;20-29;461;569;1030
2020-08-26;SA;20-29;566;745;1311
2020-08-26;SE;30-39;422;597;1019
2020-08-26;VA;30-39;971;1365;2336
2020-08-26;BU;40-49;1190;1472;2662
2020-08-26;LE;40-49;920;1425;2345
2020-08-26;SE;40-49;655;953;1608
2020-08-26;VA;40-49;1302;1842;3144
2020-08-26;AV;50-59;439;715;1154
2020-08-26;BU;50-59;1033;1475;2508
2020-08-26;PA;50-59;397;545;942
2020-08-26;SA;50-59;1086;1633;2719
2020-08-26;SE;50-59;797;1235;2032
2020-08-26;LE;60-69;798;998;1796
2020-08-26;PA;60-69;332;369;701
2020-08-26;ZA;60-69;249;277;526
2020-08-26;AV;70-79;303;335;638
2020-08-26;ZA;70-79;170;171;341
2020-08-26;CyL;70-79;3710;3829;7539
2020-08-26;AV;>80;441;758;1199
2020-08-26;LE;>80;804;1429;2233
2020-08-26;SO;>80;405;721;1126
2020-08-25;PA;0-9;116;83;199
2020-08-25;SO;0-9;119;105;224
2020-08-25;VA;0-9;602;535;1137
2020-08-25;PA;10-19;129;116;245
2020-08-25;SA;10-19;302;329;631
2020-08-25;SE;10-19;189;190;379
2020-08-25;BU;20-29;640;776;1416
2020-08-25;LE;20-29;449;563;1012
2020-08-25;VA;20-29;688;873;1561
2020-08-25;ZA;20-29;111;135;246
2020-08-25;CyL;20-29;3352;4251;7603
2020-08-25;SA;30-39;758;1080;1838
2020-08-25;PA;40-49;394;498;892
2020-08-25;SE;40-49;651;950;1601
2020-08-25;ZA;40-49;235;363;598
2020-08-25;CyL;40-49;6417;9055;15472
2020-08-25;LE;50-59;925;1398;2323
2020-08-25;VA;50-59;1062;1612;2674
2020-08-25;CyL;50-59;6370;9633;16003
2020-08-25;AV;60-69;402;472;874
2020-08-25;LE;60-69;794;996;1790
2020-08-25;SE;60-69;650;738;1388
2020-08-25;SO;60-69;290;363;653
2020-08-25;CyL;60-69;5063;6114;11177
2020-08-25;SO;70-79;202;184;386
2020-08-25;AV;>80;441;755;1196
2020-08-25;SA;>80;816;1499;2315
2020-08-25;SE;>80;664;1061;1725
2020-08-25;VA;>80;698;1423;2121
2020-08-25;ZA;>80;236;370;606
2020-08-25;BU;0-9;426;316;742
2020-08-25;LE;0-9;306;271;577
2020-08-25;SO;10-19;100;104;204
2020-08-25;VA;10-19;451;448;899
2020-08-25;ZA;10-19;94;100;194
2020-08-25;CyL;10-19;2113;2067;4180
2020-08-25;PA;20-29;213;226;439
2020-08-25;SA;20-29;555;726;1281
2020-08-25;SO;20-29;193;260;453
2020-08-25;PA;30-39;296;371;667
2020-08-25;SE;30-39;421;588;1009
2020-08-25;VA;30-39;962;1353;2315
2020-08-25;ZA;30-39;153;232;385
2020-08-25;BU;40-49;1182;1468;2650
2020-08-25;LE;40-49;920;1419;2339
2020-08-25;SA;40-49;927;1345;2272
2020-08-25;SO;40-49;348;532;880
2020-08-25;PA;50-59;396;544;940
2020-08-25;SA;50-59;1079;1621;2700
2020-08-25;BU;60-69;713;838;1551
2020-08-25;VA;60-69;834;1078;1912
2020-08-25;ZA;60-69;243;275;518
2020-08-25;AV;70-79;299;335;634
2020-08-25;PA;70-79;221;243;464
2020-08-25;SE;70-79;449;454;903
2020-08-25;VA;70-79;631;700;1331
2020-08-25;ZA;70-79;170;171;341
2020-08-25;BU;>80;635;1121;1756
2020-08-25;LE;>80;802;1419;2221
2020-08-25;SO;>80;403;718;1121
2020-08-25;CyL;>80;4941;8846;13787
2020-08-25;AV;0-9;162;130;292
2020-08-25;SA;0-9;374;391;765
2020-08-25;SE;0-9;245;193;438
2020-08-25;ZA;0-9;221;221;442
2020-08-25;CyL;0-9;2571;2245;4816
2020-08-25;AV;10-19;157;132;289
2020-08-25;BU;10-19;426;388;814
2020-08-25;LE;10-19;265;260;525
2020-08-25;AV;20-29;203;255;458
2020-08-25;SE;20-29;300;437;737
2020-08-25;AV;30-39;316;439;755
2020-08-25;BU;30-39;871;1110;1981
2020-08-25;LE;30-39;636;998;1634
2020-08-25;SO;30-39;251;355;606
2020-08-25;CyL;30-39;4664;6526;11190
2020-08-25;AV;40-49;469;655;1124
2020-08-25;VA;40-49;1291;1825;3116
2020-08-25;AV;50-59;437;714;1151
2020-08-25;BU;50-59;1024;1466;2490
2020-08-25;SE;50-59;796;1233;2029
2020-08-25;SO;50-59;381;625;1006
2020-08-25;ZA;50-59;270;420;690
2020-08-25;PA;60-69;331;367;698
2020-08-25;SA;60-69;806;987;1793
2020-08-25;BU;70-79;488;499;987
2020-08-25;LE;70-79;669;609;1278
2020-08-25;SA;70-79;562;618;1180
2020-08-25;CyL;70-79;3691;3813;7504
2020-08-25;PA;>80;246;480;726
2020-08-24;AV;0-9;155;130;285
2020-08-24;LE;0-9;305;270;575
2020-08-24;PA;0-9;113;76;189
2020-08-24;SA;0-9;363;386;749
2020-08-24;SO;0-9;118;101;219
2020-08-24;VA;0-9;585;522;1107
2020-08-24;CyL;0-9;2514;2204;4718
2020-08-24;BU;10-19;421;383;804
2020-08-24;LE;10-19;257;252;509
2020-08-24;AV;20-29;198;252;450
2020-08-24;LE;20-29;440;560;1000
2020-08-24;SE;20-29;295;433;728
2020-08-24;SO;20-29;193;258;451
2020-08-24;CyL;20-29;3290;4214;7504
2020-08-24;SO;30-39;249;353;602
2020-08-24;ZA;30-39;153;231;384
2020-08-24;CyL;30-39;4612;6457;11069
2020-08-24;BU;40-49;1176;1460;2636
2020-08-24;SA;40-49;922;1330;2252
2020-08-24;SE;40-49;644;944;1588
2020-08-24;SO;40-49;345;532;877
2020-08-24;VA;40-49;1271;1801;3072
2020-08-24;SA;50-59;1072;1614;2686
2020-08-24;SO;50-59;379;624;1003
2020-08-24;VA;50-59;1048;1595;2643
2020-08-24;AV;60-69;401;469;870
2020-08-24;BU;60-69;711;831;1542
2020-08-24;LE;60-69;788;991;1779
2020-08-24;PA;60-69;331;367;698
2020-08-24;SE;60-69;650;730;1380
2020-08-24;VA;60-69;824;1070;1894
2020-08-24;AV;70-79;298;332;630
2020-08-24;LE;70-79;667;608;1275
2020-08-24;PA;70-79;220;240;460
2020-08-24;SA;70-79;561;617;1178
2020-08-24;SE;70-79;447;452;899
2020-08-24;SO;70-79;202;185;387
2020-08-24;VA;70-79;620;693;1313
2020-08-24;ZA;70-79;169;169;338
2020-08-24;AV;>80;440;754;1194
2020-08-24;LE;>80;799;1412;2211
2020-08-24;SO;>80;403;715;1118
2020-08-24;VA;>80;698;1417;2115
2020-08-24;ZA;>80;235;368;603
2020-08-24;CyL;>80;4915;8795;13710
2020-08-24;SE;0-9;243;193;436
2020-08-24;PA;10-19;126;115;241
2020-08-24;SA;10-19;299;321;620
2020-08-24;SO;10-19;98;103;201
2020-08-24;VA;10-19;426;435;861
2020-08-24;ZA;10-19;94;97;191
2020-08-24;AV;30-39;313;430;743
2020-08-24;BU;30-39;860;1097;1957
2020-08-24;VA;30-39;945;1334;2279
2020-08-24;ZA;40-49;232;361;593
2020-08-24;CyL;40-49;6368;8977;15345
2020-08-24;PA;50-59;392;543;935
2020-08-24;SE;50-59;792;1227;2019
2020-08-24;ZA;50-59;270;411;681
2020-08-24;CyL;50-59;6325;9569;15894
2020-08-24;SA;60-69;805;981;1786
2020-08-24;SO;60-69;288;363;651
2020-08-24;CyL;60-69;5038;6075;11113
2020-08-24;PA;>80;243;475;718
2020-08-24;SA;>80;807;1481;2288
2020-08-24;BU;0-9;411;308;719
2020-08-24;ZA;0-9;221;218;439
2020-08-24;AV;10-19;151;131;282
2020-08-24;SE;10-19;188;186;374
2020-08-24;CyL;10-19;2060;2023;4083
2020-08-24;BU;20-29;631;773;1404
2020-08-24;PA;20-29;211;224;435
2020-08-24;SA;20-29;550;721;1271
2020-08-24;VA;20-29;661;860;1521
2020-08-24;ZA;20-29;111;133;244
2020-08-24;LE;30-39;629;988;1617
2020-08-24;PA;30-39;294;372;666
2020-08-24;SA;30-39;748;1069;1817
2020-08-24;SE;30-39;421;583;1004
2020-08-24;AV;40-49;465;647;1112
2020-08-24;LE;40-49;919;1409;2328
2020-08-24;PA;40-49;394;493;887
2020-08-24;AV;50-59;433;710;1143
2020-08-24;BU;50-59;1022;1460;2482
2020-08-24;LE;50-59;917;1385;2302
2020-08-24;ZA;60-69;240;273;513
2020-08-24;BU;70-79;485;493;978
2020-08-24;CyL;70-79;3669;3789;7458
2020-08-24;BU;>80;628;1116;1744
2020-08-24;SE;>80;662;1057;1719
2020-08-23;SO;0-9;118;100;218
2020-08-23;BU;10-19;420;383;803
2020-08-23;SO;10-19;97;103;200
2020-08-23;PA;20-29;211;226;437
2020-08-23;SA;20-29;535;707;1242
2020-08-23;SE;20-29;289;426;715
2020-08-23;BU;30-39;848;1099;1947
2020-08-23;SA;30-39;739;1060;1799
2020-08-23;VA;30-39;935;1326;2261
2020-08-23;BU;40-49;1174;1451;2625
2020-08-23;LE;40-49;916;1403;2319
2020-08-23;SO;40-49;342;530;872
2020-08-23;AV;50-59;432;709;1141
2020-08-23;BU;50-59;1019;1457;2476
2020-08-23;LE;50-59;915;1383;2298
2020-08-23;VA;50-59;1045;1589;2634
2020-08-23;AV;60-69;401;469;870
2020-08-23;LE;60-69;788;991;1779
2020-08-23;PA;60-69;328;365;693
2020-08-23;SA;60-69;801;975;1776
2020-08-23;VA;60-69;820;1057;1877
2020-08-23;BU;70-79;485;490;975
2020-08-23;LE;70-79;667;608;1275
2020-08-23;SO;70-79;201;185;386
2020-08-23;VA;70-79;618;690;1308
2020-08-23;BU;>80;624;1109;1733
2020-08-23;SO;>80;402;716;1118
2020-08-23;LE;0-9;303;268;571
2020-08-23;PA;0-9;118;76;194
2020-08-23;SA;0-9;352;382;734
2020-08-23;SE;0-9;247;189;436
2020-08-23;VA;0-9;574;510;1084
2020-08-23;AV;10-19;150;129;279
2020-08-23;SA;10-19;290;315;605
2020-08-23;SE;10-19;183;184;367
2020-08-23;ZA;10-19;93;97;190
2020-08-23;CyL;10-19;2028;2004;4032
2020-08-23;AV;20-29;198;250;448
2020-08-23;BU;20-29;619;761;1380
2020-08-23;SO;20-29;192;256;448
2020-08-23;LE;30-39;629;984;1613
2020-08-23;PA;30-39;289;371;660
2020-08-23;SE;30-39;418;584;1002
2020-08-23;AV;40-49;458;644;1102
2020-08-23;SA;40-49;918;1325;2243
2020-08-23;SE;40-49;641;938;1579
2020-08-23;ZA;50-59;265;405;670
2020-08-23;SE;60-69;646;728;1374
2020-08-23;SO;60-69;286;362;648
2020-08-23;ZA;60-69;239;272;511
2020-08-23;CyL;60-69;5007;6049;11056
2020-08-23;PA;70-79;217;238;455
2020-08-23;ZA;70-79;168;167;335
2020-08-23;CyL;70-79;3662;3770;7432
2020-08-23;AV;>80;439;751;1190
2020-08-23;LE;>80;798;1409;2207
2020-08-23;SE;>80;664;1057;1721
2020-08-23;VA;>80;695;1417;2112
2020-08-23;CyL;>80;4897;8760;13657
2020-08-23;AV;0-9;157;130;287
2020-08-23;BU;0-9;412;315;727
2020-08-23;ZA;0-9;221;217;438
2020-08-23;CyL;0-9;2502;2187;4689
2020-08-23;LE;10-19;256;252;508
2020-08-23;PA;10-19;123;113;236
2020-08-23;VA;10-19;416;428;844
2020-08-23;LE;20-29;432;558;990
2020-08-23;VA;20-29;642;855;1497
2020-08-23;ZA;20-29;110;133;243
2020-08-23;CyL;20-29;3228;4172;7400
2020-08-23;AV;30-39;310;427;737
2020-08-23;SO;30-39;247;354;601
2020-08-23;ZA;30-39;153;231;384
2020-08-23;CyL;30-39;4568;6436;11004
2020-08-23;PA;40-49;394;492;886
2020-08-23;VA;40-49;1260;1793;3053
2020-08-23;ZA;40-49;231;356;587
2020-08-23;CyL;40-49;6334;8932;15266
2020-08-23;PA;50-59;388;542;930
2020-08-23;SA;50-59;1067;1603;2670
2020-08-23;SE;50-59;791;1219;2010
2020-08-23;SO;50-59;378;623;1001
2020-08-23;CyL;50-59;6300;9530;15830
2020-08-23;BU;60-69;698;830;1528
2020-08-23;AV;70-79;298;329;627
2020-08-23;SA;70-79;559;614;1173
2020-08-23;SE;70-79;449;449;898
2020-08-23;PA;>80;240;471;711
2020-08-23;SA;>80;801;1463;2264
2020-08-23;ZA;>80;234;367;601
2020-08-20;BU;0-9;394;297;691
2020-08-20;BU;10-19;398;373;771
2020-08-20;SA;10-19;282;308;590
2020-08-20;SE;10-19;180;178;358
2020-08-20;VA;10-19;399;415;814
2020-08-20;CyL;10-19;1962;1942;3904
2020-08-20;AV;20-29;192;245;437
2020-08-20;BU;20-29;603;739;1342
2020-08-20;LE;20-29;426;546;972
2020-08-20;SO;20-29;185;253;438
2020-08-20;CyL;20-29;3145;4065;7210
2020-08-20;AV;30-39;307;418;725
2020-08-20;LE;30-39;626;979;1605
2020-08-20;CyL;30-39;4488;6343;10831
2020-08-20;LE;40-49;903;1395;2298
2020-08-20;SA;40-49;911;1311;2222
2020-08-20;SO;40-49;339;529;868
2020-08-20;ZA;40-49;232;352;584
2020-08-20;AV;50-59;430;705;1135
2020-08-20;LE;50-59;909;1372;2281
2020-08-20;SA;50-59;1059;1586;2645
2020-08-20;ZA;50-59;262;404;666
2020-08-20;CyL;50-59;6227;9438;15665
2020-08-20;SA;60-69;795;971;1766
2020-08-20;LE;70-79;663;603;1266
2020-08-20;LE;>80;796;1407;2203
2020-08-20;SE;>80;654;1053;1707
2020-08-20;VA;>80;691;1408;2099
2020-08-20;AV;0-9;150;127;277
2020-08-20;LE;0-9;300;264;564
2020-08-20;PA;0-9;108;73;181
2020-08-20;SA;0-9;348;380;728
2020-08-20;SO;0-9;113;94;207
2020-08-20;VA;0-9;559;504;1063
2020-08-20;CyL;0-9;2422;2132;4554
2020-08-20;PA;10-19;118;102;220
2020-08-20;SO;10-19;92;96;188
2020-08-20;ZA;10-19;92;97;189
2020-08-20;PA;20-29;204;214;418
2020-08-20;SA;20-29;522;691;1213
2020-08-20;SE;20-29;280;417;697
2020-08-20;SA;30-39;726;1036;1762
2020-08-20;SE;30-39;406;582;988
2020-08-20;SO;30-39;242;350;592
2020-08-20;VA;30-39;913;1304;2217
2020-08-20;ZA;30-39;152;227;379
2020-08-20;SE;40-49;633;934;1567
2020-08-20;VA;40-49;1246;1777;3023
2020-08-20;BU;50-59;1003;1438;2441
2020-08-20;PA;50-59;378;530;908
2020-08-20;SE;50-59;784;1215;1999
2020-08-20;SO;50-59;377;616;993
2020-08-20;AV;60-69;398;465;863
2020-08-20;BU;60-69;686;821;1507
2020-08-20;SE;60-69;638;718;1356
2020-08-20;ZA;60-69;235;269;504
2020-08-20;CyL;60-69;4942;5989;10931
2020-08-20;AV;70-79;296;325;621
2020-08-20;BU;70-79;476;475;951
2020-08-20;PA;70-79;215;235;450
2020-08-20;SA;70-79;551;611;1162
2020-08-20;SE;70-79;444;443;887
2020-08-20;SO;70-79;200;184;384
2020-08-20;PA;>80;236;463;699
2020-08-20;SA;>80;793;1441;2234
2020-08-20;SE;0-9;229;178;407
2020-08-20;ZA;0-9;221;215;436
2020-08-20;AV;10-19;146;123;269
2020-08-20;LE;10-19;255;250;505
2020-08-20;VA;20-29;627;830;1457
2020-08-20;ZA;20-29;106;130;236
2020-08-20;BU;30-39;837;1086;1923
2020-08-20;PA;30-39;279;361;640
2020-08-20;AV;40-49;451;633;1084
2020-08-20;BU;40-49;1158;1440;2598
2020-08-20;PA;40-49;386;482;868
2020-08-20;CyL;40-49;6259;8853;15112
2020-08-20;VA;50-59;1025;1572;2597
2020-08-20;LE;60-69;784;984;1768
2020-08-20;PA;60-69;319;359;678
2020-08-20;SO;60-69;284;358;642
2020-08-20;VA;60-69;803;1044;1847
2020-08-20;VA;70-79;607;682;1289
2020-08-20;ZA;70-79;166;165;331
2020-08-20;CyL;70-79;3618;3723;7341
2020-08-20;AV;>80;432;726;1158
2020-08-20;BU;>80;617;1099;1716
2020-08-20;SO;>80;399;710;1109
2020-08-20;ZA;>80;232;363;595
2020-08-20;CyL;>80;4850;8670;13520
2020-08-19;BU;0-9;386;288;674
2020-08-19;LE;0-9;300;261;561
2020-08-19;PA;0-9;106;72;178
2020-08-19;SO;0-9;109;91;200
2020-08-19;AV;10-19;143;120;263
2020-08-19;SE;10-19;179;171;350
2020-08-19;AV;20-29;191;242;433
2020-08-19;PA;20-29;200;213;413
2020-08-19;SA;20-29;511;681;1192
2020-08-19;SO;20-29;181;253;434
2020-08-19;AV;30-39;306;416;722
2020-08-19;LE;30-39;625;976;1601
2020-08-19;BU;40-49;1148;1435;2583
2020-08-19;CyL;40-49;6218;8803;15021
2020-08-19;BU;50-59;989;1427;2416
2020-08-19;LE;50-59;904;1363;2267
2020-08-19;ZA;50-59;258;401;659
2020-08-19;AV;60-69;396;463;859
2020-08-19;BU;60-69;678;810;1488
2020-08-19;LE;60-69;781;981;1762
2020-08-19;SA;60-69;785;960;1745
2020-08-19;ZA;60-69;234;268;502
2020-08-19;VA;70-79;603;675;1278
2020-08-19;CyL;70-79;3591;3691;7282
2020-08-19;AV;>80;422;690;1112
2020-08-19;LE;>80;796;1403;2199
2020-08-19;SE;>80;655;1052;1707
2020-08-19;VA;>80;688;1394;2082
2020-08-19;CyL;>80;4829;8565;13394
2020-08-19;SE;0-9;221;177;398
2020-08-19;ZA;0-9;218;215;433
2020-08-19;LE;10-19;254;241;495
2020-08-19;PA;10-19;113;100;213
2020-08-19;SO;10-19;91;95;186
2020-08-19;ZA;10-19;92;96;188
2020-08-19;CyL;10-19;1942;1903;3845
2020-08-19;SE;20-29;279;409;688
2020-08-19;CyL;20-29;3091;4013;7104
2020-08-19;PA;30-39;274;358;632
2020-08-19;SA;30-39;716;1029;1745
2020-08-19;SE;30-39;399;576;975
2020-08-19;ZA;30-39;151;227;378
2020-08-19;CyL;30-39;4438;6287;10725
2020-08-19;AV;40-49;446;633;1079
2020-08-19;SE;40-49;633;928;1561
2020-08-19;SO;40-49;337;525;862
2020-08-19;VA;40-49;1230;1759;2989
2020-08-19;AV;50-59;428;704;1132
2020-08-19;PA;50-59;376;527;903
2020-08-19;SA;50-59;1050;1571;2621
2020-08-19;SE;50-59;781;1208;1989
2020-08-19;SO;50-59;378;614;992
2020-08-19;CyL;50-59;6177;9371;15548
2020-08-19;PA;60-69;315;354;669
2020-08-19;SE;60-69;635;716;1351
2020-08-19;CyL;60-69;4902;5945;10847
2020-08-19;AV;70-79;294;318;612
2020-08-19;BU;70-79;469;471;940
2020-08-19;LE;70-79;660;599;1259
2020-08-19;PA;70-79;212;232;444
2020-08-19;SA;70-79;546;609;1155
2020-08-19;SO;>80;399;706;1105
2020-08-19;AV;0-9;149;126;275
2020-08-19;SA;0-9;344;371;715
2020-08-19;VA;0-9;547;492;1039
2020-08-19;CyL;0-9;2380;2093;4473
2020-08-19;BU;10-19;400;368;768
2020-08-19;SA;10-19;278;302;580
2020-08-19;VA;10-19;392;410;802
2020-08-19;BU;20-29;595;731;1326
2020-08-19;LE;20-29;417;540;957
2020-08-19;VA;20-29;613;814;1427
2020-08-19;ZA;20-29;104;130;234
2020-08-19;BU;30-39;828;1071;1899
2020-08-19;SO;30-39;239;348;587
2020-08-19;VA;30-39;900;1286;2186
2020-08-19;LE;40-49;897;1388;2285
2020-08-19;PA;40-49;385;482;867
2020-08-19;SA;40-49;910;1305;2215
2020-08-19;ZA;40-49;232;348;580
2020-08-19;VA;50-59;1013;1556;2569
2020-08-19;SO;60-69;284;358;642
2020-08-19;VA;60-69;794;1035;1829
2020-08-19;SE;70-79;443;439;882
2020-08-19;SO;70-79;198;183;381
2020-08-19;ZA;70-79;166;165;331
2020-08-19;BU;>80;616;1092;1708
2020-08-19;PA;>80;233;457;690
2020-08-19;SA;>80;788;1411;2199
2020-08-19;ZA;>80;232;360;592
2020-08-18;AV;0-9;148;126;274
2020-08-18;PA;0-9;108;73;181
2020-08-18;SE;0-9;219;175;394
2020-08-18;CyL;0-9;2364;2061;4425
2020-08-18;BU;10-19;395;351;746
2020-08-18;SO;10-19;91;94;185
2020-08-18;VA;10-19;389;402;791
2020-08-18;CyL;10-19;1916;1858;3774
2020-08-18;LE;20-29;414;536;950
2020-08-18;VA;20-29;601;805;1406
2020-08-18;CyL;20-29;3051;3974;7025
2020-08-18;BU;30-39;817;1061;1878
2020-08-18;LE;30-39;623;974;1597
2020-08-18;SO;30-39;234;345;579
2020-08-18;VA;30-39;894;1280;2174
2020-08-18;CyL;30-39;4393;6247;10640
2020-08-18;PA;40-49;383;480;863
2020-08-18;SA;40-49;903;1297;2200
2020-08-18;SE;40-49;633;922;1555
2020-08-18;SO;40-49;337;524;861
2020-08-18;BU;50-59;980;1407;2387
2020-08-18;SA;50-59;1045;1556;2601
2020-08-18;SO;50-59;376;609;985
2020-08-18;VA;50-59;1008;1549;2557
2020-08-18;ZA;50-59;256;399;655
2020-08-18;AV;60-69;392;459;851
2020-08-18;BU;60-69;671;799;1470
2020-08-18;LE;60-69;778;978;1756
2020-08-18;PA;60-69;313;350;663
2020-08-18;CyL;60-69;4871;5910;10781
2020-08-18;AV;70-79;290;318;608
2020-08-18;PA;70-79;212;232;444
2020-08-18;SE;70-79;441;433;874
2020-08-18;VA;70-79;601;670;1271
2020-08-18;SA;>80;786;1402;2188
2020-08-18;SO;>80;397;702;1099
2020-08-18;LE;0-9;299;255;554
2020-08-18;ZA;0-9;218;214;432
2020-08-18;AV;10-19;141;119;260
2020-08-18;SA;10-19;276;296;572
2020-08-18;ZA;10-19;90;93;183
2020-08-18;SA;20-29;504;674;1178
2020-08-18;SE;20-29;278;401;679
2020-08-18;SO;20-29;179;254;433
2020-08-18;ZA;20-29;104;130;234
2020-08-18;AV;30-39;303;415;718
2020-08-18;SA;30-39;703;1017;1720
2020-08-18;ZA;30-39;149;228;377
2020-08-18;BU;40-49;1135;1426;2561
2020-08-18;AV;50-59;426;699;1125
2020-08-18;LE;50-59;902;1357;2259
2020-08-18;PA;50-59;374;527;901
2020-08-18;SE;50-59;778;1204;1982
2020-08-18;CyL;50-59;6145;9307;15452
2020-08-18;SA;60-69;782;953;1735
2020-08-18;VA;60-69;790;1034;1824
2020-08-18;BU;70-79;463;465;928
2020-08-18;SA;70-79;543;605;1148
2020-08-18;SO;70-79;198;183;381
2020-08-18;ZA;70-79;165;164;329
2020-08-18;PA;>80;231;444;675
2020-08-18;VA;>80;686;1392;2078
2020-08-18;ZA;>80;231;360;591
2020-08-18;BU;0-9;382;276;658
2020-08-18;SA;0-9;341;368;709
2020-08-18;SO;0-9;108;90;198
2020-08-18;VA;0-9;541;484;1025
2020-08-18;LE;10-19;250;240;490
2020-08-18;PA;10-19;111;98;209
2020-08-18;SE;10-19;173;165;338
2020-08-18;AV;20-29;192;238;430
2020-08-18;BU;20-29;582;723;1305
2020-08-18;PA;20-29;197;213;410
2020-08-18;PA;30-39;274;357;631
2020-08-18;SE;30-39;396;570;966
2020-08-18;AV;40-49;444;630;1074
2020-08-18;LE;40-49;894;1380;2274
2020-08-18;VA;40-49;1218;1743;2961
2020-08-18;ZA;40-49;231;346;577
2020-08-18;CyL;40-49;6178;8748;14926
2020-08-18;SE;60-69;631;711;1342
2020-08-18;SO;60-69;280;359;639
2020-08-18;ZA;60-69;234;267;501
2020-08-18;LE;70-79;661;595;1256
2020-08-18;CyL;70-79;3574;3665;7239
2020-08-18;AV;>80;421;686;1107
2020-08-18;BU;>80;615;1082;1697
2020-08-18;LE;>80;792;1390;2182
2020-08-18;SE;>80;652;1045;1697
2020-08-18;CyL;>80;4811;8503;13314
2020-08-17;LE;0-9;297;256;553
2020-08-17;PA;0-9;106;69;175
2020-08-17;SA;0-9;332;364;696
2020-08-17;SO;0-9;106;89;195
2020-08-17;AV;10-19;141;118;259
2020-08-17;SE;10-19;170;161;331
2020-08-17;SO;10-19;89;92;181
2020-08-17;VA;10-19;382;397;779
2020-08-17;LE;20-29;412;534;946
2020-08-17;PA;20-29;197;212;409
2020-08-17;SO;20-29;176;251;427
2020-08-17;CyL;20-29;3032;3933;6965
2020-08-17;AV;30-39;300;411;711
2020-08-17;PA;30-39;273;355;628
2020-08-17;SA;30-39;696;1013;1709
2020-08-17;SE;30-39;393;568;961
2020-08-17;SA;40-49;897;1286;2183
2020-08-17;SE;40-49;626;921;1547
2020-08-17;LE;50-59;899;1356;2255
2020-08-17;PA;50-59;373;526;899
2020-08-17;SA;50-59;1041;1547;2588
2020-08-17;SE;50-59;772;1201;1973
2020-08-17;VA;50-59;1005;1546;2551
2020-08-17;ZA;50-59;253;393;646
2020-08-17;PA;60-69;311;350;661
2020-08-17;SA;60-69;775;950;1725
2020-08-17;SE;60-69;627;708;1335
2020-08-17;VA;60-69;789;1027;1816
2020-08-17;AV;70-79;288;316;604
2020-08-17;BU;70-79;461;460;921
2020-08-17;SA;70-79;541;600;1141
2020-08-17;ZA;70-79;164;161;325
2020-08-17;AV;>80;421;685;1106
2020-08-17;BU;>80;609;1074;1683
2020-08-17;LE;>80;792;1388;2180
2020-08-17;SA;>80;782;1393;2175
2020-08-17;SO;>80;391;681;1072
2020-08-17;ZA;>80;228;357;585
2020-08-17;CyL;60-69;4845;5885;10730
2020-08-17;LE;70-79;659;594;1253
2020-08-17;PA;70-79;211;232;443
2020-08-17;SE;70-79;436;430;866
2020-08-17;CyL;70-79;3556;3641;7197
2020-08-17;PA;>80;231;444;675
2020-08-17;VA;>80;685;1389;2074
2020-08-17;CyL;>80;4789;8453;13242
2020-08-17;BU;0-9;368;272;640
2020-08-17;SE;0-9;219;174;393
2020-08-17;VA;0-9;540;480;1020
2020-08-17;CyL;0-9;2334;2043;4377
2020-08-17;LE;10-19;247;238;485
2020-08-17;PA;10-19;111;97;208
2020-08-17;CyL;10-19;1878;1829;3707
2020-08-17;AV;20-29;192;238;430
2020-08-17;BU;20-29;576;712;1288
2020-08-17;SA;20-29;500;662;1162
2020-08-17;VA;20-29;598;799;1397
2020-08-17;BU;30-39;806;1049;1855
2020-08-17;LE;30-39;620;975;1595
2020-08-17;SO;30-39;234;343;577
2020-08-17;VA;30-39;884;1269;2153
2020-08-17;ZA;30-39;148;224;372
2020-08-17;AV;40-49;443;626;1069
2020-08-17;PA;40-49;383;477;860
2020-08-17;SO;40-49;333;518;851
2020-08-17;VA;40-49;1208;1731;2939
2020-08-17;CyL;40-49;6135;8689;14824
2020-08-17;AV;50-59;424;698;1122
2020-08-17;BU;50-59;973;1393;2366
2020-08-17;CyL;50-59;6114;9266;15380
2020-08-17;AV;60-69;391;458;849
2020-08-17;BU;60-69;665;794;1459
2020-08-17;LE;60-69;776;974;1750
2020-08-17;SO;60-69;279;357;636
2020-08-17;ZA;60-69;232;267;499
2020-08-17;SO;70-79;197;180;377
2020-08-17;VA;70-79;599;668;1267
2020-08-17;SE;>80;650;1042;1692
2020-08-17;AV;0-9;148;125;273
2020-08-17;ZA;0-9;218;214;432
2020-08-17;BU;10-19;379;344;723
2020-08-17;SA;10-19;272;290;562
2020-08-17;ZA;10-19;87;92;179
2020-08-17;SE;20-29;277;397;674
2020-08-17;ZA;20-29;104;128;232
2020-08-17;CyL;30-39;4354;6207;10561
2020-08-17;BU;40-49;1126;1414;2540
2020-08-17;LE;40-49;891;1374;2265
2020-08-17;ZA;40-49;228;342;570
2020-08-17;SO;50-59;374;606;980
2020-08-16;BU;0-9;364;269;633
2020-08-16;LE;0-9;295;255;550
2020-08-16;SA;10-19;265;284;549
2020-08-16;AV;20-29;191;238;429
2020-08-16;BU;20-29;566;696;1262
2020-08-16;LE;20-29;410;531;941
2020-08-16;PA;20-29;195;208;403
2020-08-16;SE;20-29;274;397;671
2020-08-16;VA;20-29;593;792;1385
2020-08-16;AV;30-39;299;409;708
2020-08-16;LE;30-39;617;974;1591
2020-08-16;PA;30-39;272;354;626
2020-08-16;SA;30-39;693;1003;1696
2020-08-16;SE;30-39;388;564;952
2020-08-16;SO;30-39;234;342;576
2020-08-16;BU;40-49;1111;1405;2516
2020-08-16;SA;40-49;892;1275;2167
2020-08-16;CyL;40-49;6100;8644;14744
2020-08-16;AV;50-59;424;696;1120
2020-08-16;VA;50-59;1001;1538;2539
2020-08-16;AV;60-69;389;457;846
2020-08-16;SE;60-69;624;701;1325
2020-08-16;CyL;60-69;4827;5862;10689
2020-08-16;LE;70-79;658;594;1252
2020-08-16;SE;70-79;434;427;861
2020-08-16;SO;70-79;197;178;375
2020-08-16;PA;>80;227;441;668
2020-08-16;PA;0-9;102;68;170
2020-08-16;SE;0-9;212;172;384
2020-08-16;VA;0-9;539;477;1016
2020-08-16;ZA;0-9;218;214;432
2020-08-16;CyL;0-9;2307;2028;4335
2020-08-16;LE;10-19;245;236;481
2020-08-16;SO;10-19;87;91;178
2020-08-16;ZA;10-19;87;92;179
2020-08-16;SO;20-29;174;248;422
2020-08-16;ZA;20-29;104;129;233
2020-08-16;BU;30-39;801;1040;1841
2020-08-16;ZA;30-39;148;223;371
2020-08-16;AV;40-49;442;621;1063
2020-08-16;PA;40-49;383;474;857
2020-08-16;SE;40-49;622;913;1535
2020-08-16;SO;40-49;331;517;848
2020-08-16;ZA;40-49;228;342;570
2020-08-16;BU;50-59;966;1382;2348
2020-08-16;LE;50-59;896;1354;2250
2020-08-16;SA;50-59;1036;1537;2573
2020-08-16;SE;50-59;771;1198;1969
2020-08-16;ZA;50-59;252;392;644
2020-08-16;CyL;50-59;6090;9220;15310
2020-08-16;PA;60-69;311;347;658
2020-08-16;VA;60-69;784;1025;1809
2020-08-16;ZA;60-69;232;267;499
2020-08-16;BU;70-79;457;461;918
2020-08-16;PA;70-79;210;229;439
2020-08-16;ZA;70-79;164;161;325
2020-08-16;AV;>80;419;685;1104
2020-08-16;BU;>80;596;1056;1652
2020-08-16;LE;>80;791;1386;2177
2020-08-16;SE;>80;649;1039;1688
2020-08-16;SO;>80;390;681;1071
2020-08-16;VA;>80;682;1385;2067
2020-08-16;ZA;>80;228;356;584
2020-08-16;AV;0-9;146;125;271
2020-08-16;SA;0-9;326;360;686
2020-08-16;SO;0-9;105;88;193
2020-08-16;AV;10-19;140;118;258
2020-08-16;BU;10-19;366;337;703
2020-08-16;PA;10-19;110;96;206
2020-08-16;SE;10-19;166;159;325
2020-08-16;VA;10-19;382;393;775
2020-08-16;CyL;10-19;1848;1806;3654
2020-08-16;SA;20-29;493;653;1146
2020-08-16;CyL;20-29;3000;3892;6892
2020-08-16;VA;30-39;880;1261;2141
2020-08-16;CyL;30-39;4332;6170;10502
2020-08-16;LE;40-49;890;1370;2260
2020-08-16;VA;40-49;1201;1727;2928
2020-08-16;PA;50-59;372;517;889
2020-08-16;SO;50-59;372;606;978
2020-08-16;BU;60-69;662;793;1455
2020-08-16;LE;60-69;774;972;1746
2020-08-16;SA;60-69;772;944;1716
2020-08-16;SO;60-69;279;356;635
2020-08-16;AV;70-79;288;315;603
2020-08-16;SA;70-79;538;597;1135
2020-08-16;VA;70-79;596;666;1262
2020-08-16;CyL;70-79;3542;3628;7170
2020-08-16;SA;>80;780;1385;2165
2020-08-16;CyL;>80;4762;8414;13176
2020-08-13;BU;0-9;352;258;610
2020-08-13;PA;0-9;100;67;167
2020-08-13;SA;0-9;331;356;687
2020-08-13;VA;0-9;535;473;1008
2020-08-13;ZA;0-9;219;210;429
2020-08-13;LE;10-19;241;233;474
2020-08-13;SA;10-19;254;281;535
2020-08-13;SE;10-19;162;156;318
2020-08-13;CyL;10-19;1780;1746;3526
2020-08-13;AV;20-29;186;231;417
2020-08-13;BU;20-29;554;675;1229
2020-08-13;SO;20-29;170;242;412
2020-08-13;VA;20-29;569;778;1347
2020-08-13;ZA;20-29;99;127;226
2020-08-13;BU;30-39;782;1015;1797
2020-08-13;LE;30-39;612;969;1581
2020-08-13;SA;30-39;684;990;1674
2020-08-13;VA;30-39;863;1237;2100
2020-08-13;BU;40-49;1093;1386;2479
2020-08-13;VA;40-49;1186;1709;2895
2020-08-13;ZA;40-49;221;337;558
2020-08-13;CyL;40-49;6022;8571;14593
2020-08-13;AV;50-59;422;691;1113
2020-08-13;BU;50-59;953;1358;2311
2020-08-13;LE;50-59;894;1351;2245
2020-08-13;PA;50-59;368;512;880
2020-08-13;SA;50-59;1024;1523;2547
2020-08-13;SE;50-59;764;1192;1956
2020-08-13;VA;50-59;988;1529;2517
2020-08-13;SO;60-69;279;353;632
2020-08-13;CyL;60-69;4808;5818;10626
2020-08-13;BU;70-79;453;450;903
2020-08-13;LE;70-79;655;589;1244
2020-08-13;SA;70-79;536;595;1131
2020-08-13;SO;70-79;195;176;371
2020-08-13;BU;>80;593;1043;1636
2020-08-13;SA;>80;772;1369;2141
2020-08-13;SE;>80;639;1031;1670
2020-08-13;VA;>80;678;1377;2055
2020-08-13;ZA;>80;226;354;580
2020-08-13;CyL;>80;4722;8343;13065
2020-08-13;AV;0-9;145;124;269
2020-08-13;LE;0-9;291;254;545
2020-08-13;SE;0-9;202;169;371
2020-08-13;SO;0-9;102;84;186
2020-08-13;BU;10-19;341;324;665
2020-08-13;PA;10-19;108;94;202
2020-08-13;SO;10-19;84;87;171
2020-08-13;VA;10-19;370;370;740
2020-08-13;LE;20-29;406;522;928
2020-08-13;PA;20-29;187;205;392
2020-08-13;SA;20-29;482;640;1122
2020-08-13;SE;20-29;268;389;657
2020-08-13;ZA;30-39;142;222;364
2020-08-13;LE;40-49;887;1368;2255
2020-08-13;PA;40-49;377;473;850
2020-08-13;SE;40-49;616;906;1522
2020-08-13;CyL;50-59;6027;9144;15171
2020-08-13;PA;60-69;309;342;651
2020-08-13;SA;60-69;767;933;1700
2020-08-13;VA;60-69;780;1023;1803
2020-08-13;ZA;70-79;164;158;322
2020-08-13;CyL;70-79;3506;3592;7098
2020-08-13;PA;>80;225;438;663
2020-08-13;CyL;0-9;2277;1995;4272
2020-08-13;AV;10-19;140;110;250
2020-08-13;ZA;10-19;80;91;171
2020-08-13;CyL;20-29;2921;3809;6730
2020-08-13;AV;30-39;292;408;700
2020-08-13;PA;30-39;266;345;611
2020-08-13;SE;30-39;385;559;944
2020-08-13;SO;30-39;231;339;570
2020-08-13;CyL;30-39;4257;6084;10341
2020-08-13;AV;40-49;439;617;1056
2020-08-13;SA;40-49;879;1263;2142
2020-08-13;SO;40-49;324;512;836
2020-08-13;SO;50-59;367;601;968
2020-08-13;ZA;50-59;247;387;634
2020-08-13;AV;60-69;389;454;843
2020-08-13;BU;60-69;658;780;1438
2020-08-13;LE;60-69;776;969;1745
2020-08-13;SE;60-69;620;697;1317
2020-08-13;ZA;60-69;230;267;497
2020-08-13;AV;70-79;284;311;595
2020-08-13;PA;70-79;206;228;434
2020-08-13;SE;70-79;429;423;852
2020-08-13;VA;70-79;584;662;1246
2020-08-13;AV;>80;415;674;1089
2020-08-13;LE;>80;790;1385;2175
2020-08-13;SO;>80;384;672;1056
2020-08-12;BU;0-9;351;260;611
2020-08-12;PA;0-9;99;66;165
2020-08-12;SA;0-9;328;356;684
2020-08-12;SO;0-9;102;83;185
2020-08-12;ZA;0-9;217;209;426
2020-08-12;AV;10-19;140;108;248
2020-08-12;BU;10-19;330;312;642
2020-08-12;SA;10-19;251;274;525
2020-08-12;SE;10-19;157;153;310
2020-08-12;SO;10-19;84;86;170
2020-08-12;CyL;10-19;1750;1714;3464
2020-08-12;BU;20-29;548;668;1216
2020-08-12;AV;30-39;291;407;698
2020-08-12;BU;30-39;775;1004;1779
2020-08-12;ZA;30-39;142;223;365
2020-08-12;AV;40-49;437;617;1054
2020-08-12;SO;40-49;320;510;830
2020-08-12;CyL;40-49;5997;8538;14535
2020-08-12;SE;50-59;758;1191;1949
2020-08-12;VA;50-59;984;1526;2510
2020-08-12;SE;60-69;620;695;1315
2020-08-12;ZA;60-69;230;266;496
2020-08-12;CyL;60-69;4789;5801;10590
2020-08-12;AV;70-79;281;309;590
2020-08-12;SA;70-79;533;591;1124
2020-08-12;AV;>80;410;669;1079
2020-08-12;BU;>80;590;1040;1630
2020-08-12;SA;>80;769;1357;2126
2020-08-12;SO;>80;383;666;1049
2020-08-12;VA;>80;676;1373;2049
2020-08-12;ZA;>80;224;352;576
2020-08-12;AV;0-9;143;122;265
2020-08-12;VA;0-9;532;470;1002
2020-08-12;VA;10-19;363;367;730
2020-08-12;VA;20-29;562;773;1335
2020-08-12;CyL;20-29;2891;3778;6669
2020-08-12;SA;30-39;672;979;1651
2020-08-12;VA;30-39;854;1226;2080
2020-08-12;BU;40-49;1093;1375;2468
2020-08-12;SA;40-49;876;1256;2132
2020-08-12;ZA;40-49;221;335;556
2020-08-12;AV;50-59;417;688;1105
2020-08-12;BU;50-59;947;1350;2297
2020-08-12;LE;50-59;889;1346;2235
2020-08-12;PA;50-59;366;509;875
2020-08-12;SA;50-59;1019;1518;2537
2020-08-12;SO;50-59;363;598;961
2020-08-12;AV;60-69;386;453;839
2020-08-12;SA;60-69;765;928;1693
2020-08-12;SO;60-69;277;353;630
2020-08-12;BU;70-79;448;449;897
2020-08-12;PA;70-79;205;227;432
2020-08-12;SE;70-79;426;423;849
2020-08-12;SO;70-79;194;176;370
2020-08-12;VA;70-79;583;658;1241
2020-08-12;LE;>80;791;1383;2174
2020-08-12;SE;>80;639;1026;1665
2020-08-12;LE;0-9;291;257;548
2020-08-12;SE;0-9;199;167;366
2020-08-12;CyL;0-9;2262;1990;4252
2020-08-12;LE;10-19;239;232;471
2020-08-12;PA;10-19;106;92;198
2020-08-12;ZA;10-19;80;90;170
2020-08-12;AV;20-29;183;231;414
2020-08-12;LE;20-29;403;517;920
2020-08-12;PA;20-29;184;204;388
2020-08-12;SA;20-29;477;637;1114
2020-08-12;SE;20-29;264;385;649
2020-08-12;SO;20-29;171;237;408
2020-08-12;ZA;20-29;99;126;225
2020-08-12;LE;30-39;611;969;1580
2020-08-12;PA;30-39;263;344;607
2020-08-12;SE;30-39;380;555;935
2020-08-12;SO;30-39;228;333;561
2020-08-12;CyL;30-39;4216;6040;10256
2020-08-12;LE;40-49;881;1369;2250
2020-08-12;PA;40-49;375;467;842
2020-08-12;SE;40-49;612;904;1516
2020-08-12;VA;40-49;1182;1705;2887
2020-08-12;ZA;50-59;247;386;633
2020-08-12;CyL;50-59;5990;9112;15102
2020-08-12;BU;60-69;652;776;1428
2020-08-12;LE;60-69;774;971;1745
2020-08-12;PA;60-69;308;338;646
2020-08-12;VA;60-69;777;1021;1798
2020-08-12;LE;70-79;655;587;1242
2020-08-12;ZA;70-79;164;159;323
2020-08-12;CyL;70-79;3489;3579;7068
2020-08-12;PA;>80;224;436;660
2020-08-12;CyL;>80;4706;8302;13008
2020-08-11;AV;0-9;142;121;263
2020-08-11;LE;0-9;290;254;544
2020-08-11;SA;0-9;325;357;682
2020-08-11;ZA;0-9;216;209;425
2020-08-11;CyL;0-9;2242;1976;4218
2020-08-11;BU;10-19;328;302;630
2020-08-11;PA;10-19;106;91;197
2020-08-11;CyL;10-19;1741;1688;3429
2020-08-11;AV;20-29;180;230;410
2020-08-11;LE;20-29;399;515;914
2020-08-11;SA;20-29;468;632;1100
2020-08-11;SE;20-29;260;380;640
2020-08-11;SO;20-29;167;236;403
2020-08-11;VA;30-39;848;1221;2069
2020-08-11;SA;40-49;868;1247;2115
2020-08-11;VA;40-49;1176;1698;2874
2020-08-11;ZA;40-49;218;335;553
2020-08-11;CyL;40-49;5959;8494;14453
2020-08-11;AV;50-59;415;686;1101
2020-08-11;BU;50-59;943;1339;2282
2020-08-11;PA;50-59;363;507;870
2020-08-11;ZA;50-59;246;386;632
2020-08-11;AV;60-69;383;453;836
2020-08-11;VA;60-69;773;1016;1789
2020-08-11;SE;70-79;426;423;849
2020-08-11;SO;70-79;192;175;367
2020-08-11;ZA;70-79;162;159;321
2020-08-11;CyL;70-79;3475;3571;7046
2020-08-11;LE;>80;791;1381;2172
2020-08-11;SE;>80;639;1023;1662
2020-08-11;ZA;>80;224;352;576
2020-08-11;CyL;>80;4696;8276;12972
2020-08-11;SE;0-9;197;165;362
2020-08-11;AV;10-19;138;108;246
2020-08-11;LE;10-19;239;227;466
2020-08-11;SE;10-19;158;150;308
2020-08-11;ZA;10-19;79;90;169
2020-08-11;BU;20-29;534;661;1195
2020-08-11;BU;30-39;760;995;1755
2020-08-11;SE;30-39;379;553;932
2020-08-11;ZA;30-39;141;223;364
2020-08-11;AV;40-49;436;615;1051
2020-08-11;BU;40-49;1083;1361;2444
2020-08-11;SE;40-49;611;900;1511
2020-08-11;SO;40-49;317;509;826
2020-08-11;SA;50-59;1017;1509;2526
2020-08-11;SO;50-59;362;595;957
2020-08-11;CyL;50-59;5971;9076;15047
2020-08-11;SO;60-69;275;352;627
2020-08-11;ZA;60-69;227;265;492
2020-08-11;AV;70-79;280;309;589
2020-08-11;LE;70-79;653;585;1238
2020-08-11;PA;70-79;205;226;431
2020-08-11;AV;>80;408;664;1072
2020-08-11;BU;>80;589;1034;1623
2020-08-11;PA;>80;223;435;658
2020-08-11;SA;>80;765;1354;2119
2020-08-11;BU;0-9;346;259;605
2020-08-11;PA;0-9;99;63;162
2020-08-11;SO;0-9;99;81;180
2020-08-11;VA;0-9;528;467;995
2020-08-11;SA;10-19;251;272;523
2020-08-11;SO;10-19;82;83;165
2020-08-11;VA;10-19;360;365;725
2020-08-11;PA;20-29;179;206;385
2020-08-11;VA;20-29;557;769;1326
2020-08-11;ZA;20-29;96;123;219
2020-08-11;CyL;20-29;2840;3752;6592
2020-08-11;AV;30-39;290;406;696
2020-08-11;LE;30-39;609;965;1574
2020-08-11;PA;30-39;262;344;606
2020-08-11;SA;30-39;669;974;1643
2020-08-11;SO;30-39;226;334;560
2020-08-11;CyL;30-39;4184;6015;10199
2020-08-11;LE;40-49;877;1363;2240
2020-08-11;PA;40-49;373;466;839
2020-08-11;LE;50-59;885;1343;2228
2020-08-11;SE;50-59;756;1187;1943
2020-08-11;VA;50-59;984;1524;2508
2020-08-11;BU;60-69;648;774;1422
2020-08-11;LE;60-69;774;970;1744
2020-08-11;PA;60-69;305;339;644
2020-08-11;SA;60-69;763;925;1688
2020-08-11;SE;60-69;621;694;1315
2020-08-11;CyL;60-69;4769;5788;10557
2020-08-11;BU;70-79;443;449;892
2020-08-11;SA;70-79;532;588;1120
2020-08-11;VA;70-79;582;657;1239
2020-08-11;SO;>80;383;662;1045
2020-08-11;VA;>80;674;1371;2045
2020-08-10;SO;10-19;80;82;162
2020-08-10;AV;20-29;177;230;407
2020-08-10;LE;20-29;400;510;910
2020-08-10;SA;20-29;459;626;1085
2020-08-10;SO;20-29;166;235;401
2020-08-10;VA;20-29;552;760;1312
2020-08-10;AV;30-39;290;404;694
2020-08-10;BU;30-39;750;983;1733
2020-08-10;SA;30-39;664;966;1630
2020-08-10;SE;30-39;380;552;932
2020-08-10;BU;40-49;1078;1349;2427
2020-08-10;PA;40-49;371;467;838
2020-08-10;VA;40-49;1169;1688;2857
2020-08-10;ZA;40-49;218;335;553
2020-08-10;CyL;40-49;5933;8465;14398
2020-08-10;AV;50-59;413;682;1095
2020-08-10;BU;50-59;935;1330;2265
2020-08-10;ZA;50-59;244;386;630
2020-08-10;CyL;50-59;5944;9046;14990
2020-08-10;LE;60-69;770;966;1736
2020-08-10;AV;70-79;280;309;589
2020-08-10;BU;70-79;436;441;877
2020-08-10;SA;70-79;531;587;1118
2020-08-10;SE;70-79;427;422;849
2020-08-10;CyL;70-79;3468;3553;7021
2020-08-10;PA;>80;225;430;655
2020-08-10;VA;>80;674;1368;2042
2020-08-10;SO;0-9;96;80;176
2020-08-10;AV;0-9;142;122;264
2020-08-10;LE;0-9;289;253;542
2020-08-10;PA;0-9;99;60;159
2020-08-10;SE;0-9;199;168;367
2020-08-10;ZA;0-9;215;208;423
2020-08-10;LE;10-19;238;225;463
2020-08-10;SA;10-19;246;267;513
2020-08-10;SE;10-19;152;147;299
2020-08-10;CyL;10-19;1711;1667;3378
2020-08-10;BU;20-29;528;650;1178
2020-08-10;PA;20-29;178;208;386
2020-08-10;CyL;20-29;2817;3719;6536
2020-08-10;LE;30-39;605;965;1570
2020-08-10;PA;30-39;260;343;603
2020-08-10;SO;30-39;222;331;553
2020-08-10;VA;30-39;843;1214;2057
2020-08-10;CyL;30-39;4157;5982;10139
2020-08-10;SE;40-49;608;901;1509
2020-08-10;LE;50-59;887;1341;2228
2020-08-10;SE;50-59;756;1184;1940
2020-08-10;VA;50-59;980;1520;2500
2020-08-10;AV;60-69;378;450;828
2020-08-10;BU;60-69;646;765;1411
2020-08-10;PA;60-69;304;338;642
2020-08-10;SA;60-69;761;927;1688
2020-08-10;SE;60-69;619;695;1314
2020-08-10;VA;60-69;771;1009;1780
2020-08-10;ZA;60-69;227;263;490
2020-08-10;PA;70-79;205;226;431
2020-08-10;SO;70-79;192;174;366
2020-08-10;AV;>80;406;658;1064
2020-08-10;BU;>80;587;1026;1613
2020-08-10;LE;>80;789;1378;2167
2020-08-10;SA;>80;763;1349;2112
2020-08-10;SO;>80;383;661;1044
2020-08-10;AV;10-19;137;106;243
2020-08-10;BU;10-19;317;300;617
2020-08-10;PA;10-19;105;88;193
2020-08-10;VA;10-19;358;362;720
2020-08-10;ZA;10-19;78;90;168
2020-08-10;SE;20-29;262;379;641
2020-08-10;ZA;20-29;95;121;216
2020-08-10;ZA;30-39;143;224;367
2020-08-10;AV;40-49;434;612;1046
2020-08-10;LE;40-49;875;1361;2236
2020-08-10;SA;40-49;864;1243;2107
2020-08-10;SO;40-49;316;509;825
2020-08-10;PA;50-59;360;506;866
2020-08-10;SA;50-59;1010;1503;2513
2020-08-10;SO;50-59;359;594;953
2020-08-10;SO;60-69;275;351;626
2020-08-10;CyL;60-69;4751;5764;10515
2020-08-10;LE;70-79;653;582;1235
2020-08-10;VA;70-79;582;654;1236
2020-08-10;ZA;70-79;162;158;320
2020-08-10;SE;>80;636;1019;1655
2020-08-10;ZA;>80;224;352;576
2020-08-10;CyL;>80;4687;8241;12928
2020-08-10;BU;0-9;334;248;582
2020-08-10;SA;0-9;316;352;668
2020-08-10;VA;0-9;519;455;974
2020-08-10;CyL;0-9;2209;1946;4155
2020-08-09;SA;0-9;308;348;656
2020-08-09;VA;0-9;511;449;960
2020-08-09;ZA;0-9;215;207;422
2020-08-09;LE;10-19;236;224;460
2020-08-09;SA;10-19;241;261;502
2020-08-09;VA;10-19;356;359;715
2020-08-09;AV;20-29;177;230;407
2020-08-09;SA;20-29;450;623;1073
2020-08-09;SE;20-29;263;379;642
2020-08-09;SO;20-29;166;233;399
2020-08-09;ZA;30-39;143;224;367
2020-08-09;CyL;30-39;4135;5964;10099
2020-08-09;BU;40-49;1068;1336;2404
2020-08-09;CyL;40-49;5900;8435;14335
2020-08-09;BU;50-59;925;1324;2249
2020-08-09;PA;50-59;360;506;866
2020-08-09;SA;50-59;1006;1502;2508
2020-08-09;VA;50-59;979;1518;2497
2020-08-09;BU;60-69;639;758;1397
2020-08-09;SA;60-69;759;923;1682
2020-08-09;CyL;60-69;4734;5745;10479
2020-08-09;BU;70-79;434;432;866
2020-08-09;SE;70-79;421;419;840
2020-08-09;BU;>80;583;1018;1601
2020-08-09;SA;>80;762;1346;2108
2020-08-09;SO;>80;383;661;1044
2020-08-09;CyL;>80;4673;8217;12890
2020-08-09;CyL;0-9;2177;1916;4093
2020-08-09;AV;10-19;137;106;243
2020-08-09;SE;10-19;147;149;296
2020-08-09;SO;10-19;80;82;162
2020-08-09;CyL;10-19;1685;1650;3335
2020-08-09;LE;20-29;396;508;904
2020-08-09;BU;30-39;746;970;1716
2020-08-09;SO;30-39;218;331;549
2020-08-09;VA;30-39;838;1213;2051
2020-08-09;AV;40-49;430;612;1042
2020-08-09;PA;40-49;369;467;836
2020-08-09;SA;40-49;859;1238;2097
2020-08-09;SE;40-49;603;897;1500
2020-08-09;LE;50-59;886;1338;2224
2020-08-09;SE;50-59;753;1182;1935
2020-08-09;SO;50-59;356;595;951
2020-08-09;ZA;50-59;244;386;630
2020-08-09;CyL;50-59;5922;9031;14953
2020-08-09;AV;60-69;377;447;824
2020-08-09;PA;60-69;304;338;642
2020-08-09;SO;60-69;275;350;625
2020-08-09;ZA;60-69;226;263;489
2020-08-09;AV;70-79;280;306;586
2020-08-09;PA;70-79;205;226;431
2020-08-09;SA;70-79;529;584;1113
2020-08-09;SO;70-79;193;173;366
2020-08-09;VA;70-79;580;654;1234
2020-08-09;AV;>80;404;654;1058
2020-08-09;SE;>80;634;1016;1650
2020-08-09;VA;>80;673;1363;2036
2020-08-09;AV;0-9;141;121;262
2020-08-09;BU;0-9;322;234;556
2020-08-09;LE;0-9;293;253;546
2020-08-09;PA;0-9;95;58;153
2020-08-09;SE;0-9;196;167;363
2020-08-09;SO;0-9;96;79;175
2020-08-09;BU;10-19;305;291;596
2020-08-09;PA;10-19;106;88;194
2020-08-09;ZA;10-19;77;90;167
2020-08-09;BU;20-29;511;636;1147
2020-08-09;PA;20-29;175;204;379
2020-08-09;VA;20-29;549;755;1304
2020-08-09;ZA;20-29;95;120;215
2020-08-09;CyL;20-29;2782;3688;6470
2020-08-09;AV;30-39;290;404;694
2020-08-09;LE;30-39;605;965;1570
2020-08-09;PA;30-39;258;343;601
2020-08-09;SA;30-39;658;963;1621
2020-08-09;SE;30-39;379;551;930
2020-08-09;LE;40-49;873;1359;2232
2020-08-09;SO;40-49;314;509;823
2020-08-09;VA;40-49;1166;1682;2848
2020-08-09;ZA;40-49;218;335;553
2020-08-09;AV;50-59;413;680;1093
2020-08-09;LE;60-69;770;965;1735
2020-08-09;SE;60-69;615;692;1307
2020-08-09;VA;60-69;769;1009;1778
2020-08-09;LE;70-79;651;581;1232
2020-08-09;ZA;70-79;162;157;319
2020-08-09;CyL;70-79;3455;3532;6987
2020-08-09;LE;>80;787;1378;2165
2020-08-09;PA;>80;223;429;652
2020-08-09;ZA;>80;224;352;576
2020-08-06;VA;0-9;504;444;948
2020-08-06;ZA;0-9;214;206;420
2020-08-06;PA;10-19;104;89;193
2020-08-06;SE;10-19;140;147;287
2020-08-06;CyL;10-19;1624;1599;3223
2020-08-06;PA;20-29;170;201;371
2020-08-06;SO;20-29;162;232;394
2020-08-06;VA;20-29;545;745;1290
2020-08-06;ZA;20-29;91;118;209
2020-08-06;CyL;20-29;2726;3606;6332
2020-08-06;PA;30-39;256;339;595
2020-08-06;ZA;30-39;141;220;361
2020-08-06;BU;40-49;1044;1302;2346
2020-08-06;SO;40-49;308;503;811
2020-08-06;ZA;40-49;218;332;550
2020-08-06;SO;50-59;356;594;950
2020-08-06;SE;60-69;614;689;1303
2020-08-06;AV;70-79;279;305;584
2020-08-06;PA;70-79;203;225;428
2020-08-06;SA;70-79;526;581;1107
2020-08-06;SE;70-79;421;419;840
2020-08-06;CyL;70-79;3433;3512;6945
2020-08-06;AV;>80;402;651;1053
2020-08-06;BU;>80;575;1008;1583
2020-08-06;ZA;>80;223;351;574
2020-08-06;BU;0-9;311;226;537
2020-08-06;SA;0-9;302;345;647
2020-08-06;SO;0-9;95;79;174
2020-08-06;BU;10-19;281;274;555
2020-08-06;SA;10-19;235;251;486
2020-08-06;SO;10-19;79;79;158
2020-08-06;BU;20-29;492;604;1096
2020-08-06;SE;20-29;263;374;637
2020-08-06;BU;30-39;725;947;1672
2020-08-06;LE;30-39;601;959;1560
2020-08-06;VA;30-39;826;1203;2029
2020-08-06;CyL;30-39;4065;5895;9960
2020-08-06;AV;40-49;427;608;1035
2020-08-06;LE;40-49;864;1350;2214
2020-08-06;VA;40-49;1150;1672;2822
2020-08-06;CyL;50-59;5871;8975;14846
2020-08-06;AV;60-69;375;444;819
2020-08-06;LE;60-69;766;962;1728
2020-08-06;PA;60-69;304;337;641
2020-08-06;SO;60-69;271;347;618
2020-08-06;VA;60-69;768;1002;1770
2020-08-06;ZA;60-69;226;262;488
2020-08-06;BU;70-79;429;423;852
2020-08-06;LE;70-79;650;578;1228
2020-08-06;SO;70-79;187;172;359
2020-08-06;VA;70-79;577;655;1232
2020-08-06;ZA;70-79;161;154;315
2020-08-06;LE;>80;785;1378;2163
2020-08-06;PA;>80;222;429;651
2020-08-06;SA;>80;761;1336;2097
2020-08-06;SE;>80;630;1013;1643
2020-08-06;AV;0-9;140;122;262
2020-08-06;LE;0-9;286;252;538
2020-08-06;PA;0-9;94;55;149
2020-08-06;SE;0-9;193;163;356
2020-08-06;CyL;0-9;2139;1892;4031
2020-08-06;AV;10-19;133;100;233
2020-08-06;LE;10-19;229;222;451
2020-08-06;VA;10-19;346;348;694
2020-08-06;ZA;10-19;77;89;166
2020-08-06;AV;20-29;176;228;404
2020-08-06;LE;20-29;389;503;892
2020-08-06;SA;20-29;438;601;1039
2020-08-06;AV;30-39;290;402;692
2020-08-06;SA;30-39;645;951;1596
2020-08-06;SE;30-39;370;545;915
2020-08-06;SO;30-39;211;329;540
2020-08-06;PA;40-49;370;465;835
2020-08-06;SA;40-49;851;1229;2080
2020-08-06;SE;40-49;599;895;1494
2020-08-06;CyL;40-49;5831;8356;14187
2020-08-06;AV;50-59;410;676;1086
2020-08-06;BU;50-59;907;1305;2212
2020-08-06;LE;50-59;879;1334;2213
2020-08-06;PA;50-59;358;500;858
2020-08-06;SA;50-59;998;1497;2495
2020-08-06;SE;50-59;749;1180;1929
2020-08-06;VA;50-59;970;1506;2476
2020-08-06;ZA;50-59;244;383;627
2020-08-06;BU;60-69;617;745;1362
2020-08-06;SA;60-69;757;922;1679
2020-08-06;CyL;60-69;4698;5710;10408
2020-08-06;SO;>80;382;657;1039
2020-08-06;VA;>80;671;1358;2029
2020-08-06;CyL;>80;4651;8181;12832
2020-08-05;AV;0-9;138;122;260
2020-08-05;BU;0-9;305;216;521
2020-08-05;SA;0-9;301;343;644
2020-08-05;SE;0-9;191;161;352
2020-08-05;AV;10-19;132;100;232
2020-08-05;BU;10-19;275;265;540
2020-08-05;LE;10-19;225;220;445
2020-08-05;SE;10-19;141;143;284
2020-08-05;ZA;10-19;77;89;166
2020-08-05;CyL;10-19;1609;1579;3188
2020-08-05;AV;20-29;176;228;404
2020-08-05;LE;20-29;386;503;889
2020-08-05;SE;20-29;255;371;626
2020-08-05;AV;30-39;288;401;689
2020-08-05;SA;30-39;644;948;1592
2020-08-05;SO;30-39;209;327;536
2020-08-05;CyL;30-39;4048;5872;9920
2020-08-05;BU;40-49;1035;1293;2328
2020-08-05;LE;40-49;864;1348;2212
2020-08-05;SA;40-49;847;1225;2072
2020-08-05;CyL;40-49;5807;8336;14143
2020-08-05;AV;50-59;410;673;1083
2020-08-05;BU;50-59;901;1299;2200
2020-08-05;LE;50-59;879;1332;2211
2020-08-05;SA;50-59;994;1493;2487
2020-08-05;CyL;50-59;5855;8947;14802
2020-08-05;LE;60-69;764;958;1722
2020-08-05;ZA;60-69;226;260;486
2020-08-05;AV;70-79;277;303;580
2020-08-05;LE;70-79;648;576;1224
2020-08-05;SE;70-79;422;419;841
2020-08-05;SO;70-79;185;169;354
2020-08-05;ZA;>80;223;351;574
2020-08-05;PA;0-9;95;55;150
2020-08-05;SO;0-9;92;77;169
2020-08-05;ZA;0-9;214;205;419
2020-08-05;PA;10-19;104;89;193
2020-08-05;SA;10-19;233;250;483
2020-08-05;SO;10-19;79;78;157
2020-08-05;VA;10-19;343;345;688
2020-08-05;PA;20-29;168;201;369
2020-08-05;PA;30-39;255;339;594
2020-08-05;ZA;30-39;141;220;361
2020-08-05;AV;40-49;424;606;1030
2020-08-05;PA;40-49;368;464;832
2020-08-05;SE;40-49;598;897;1495
2020-08-05;SO;40-49;306;503;809
2020-08-05;VA;40-49;1147;1668;2815
2020-08-05;PA;50-59;357;500;857
2020-08-05;SE;50-59;748;1178;1926
2020-08-05;ZA;50-59;244;383;627
2020-08-05;AV;60-69;372;442;814
2020-08-05;BU;60-69;611;740;1351
2020-08-05;PA;60-69;302;338;640
2020-08-05;SE;60-69;611;688;1299
2020-08-05;CyL;60-69;4679;5692;10371
2020-08-05;SA;70-79;524;580;1104
2020-08-05;AV;>80;402;649;1051
2020-08-05;BU;>80;573;1002;1575
2020-08-05;LE;>80;785;1378;2163
2020-08-05;PA;>80;222;427;649
2020-08-05;SA;>80;757;1332;2089
2020-08-05;SE;>80;630;1013;1643
2020-08-05;VA;>80;669;1356;2025
2020-08-05;LE;0-9;284;250;534
2020-08-05;VA;0-9;501;442;943
2020-08-05;CyL;0-9;2121;1871;3992
2020-08-05;BU;20-29;477;595;1072
2020-08-05;SA;20-29;433;593;1026
2020-08-05;SO;20-29;161;231;392
2020-08-05;VA;20-29;541;742;1283
2020-08-05;ZA;20-29;89;118;207
2020-08-05;CyL;20-29;2686;3582;6268
2020-08-05;BU;30-39;719;938;1657
2020-08-05;LE;30-39;600;955;1555
2020-08-05;SE;30-39;370;545;915
2020-08-05;VA;30-39;822;1199;2021
2020-08-05;ZA;40-49;218;332;550
2020-08-05;SO;50-59;355;590;945
2020-08-05;VA;50-59;967;1499;2466
2020-08-05;SA;60-69;756;919;1675
2020-08-05;SO;60-69;269;346;615
2020-08-05;VA;60-69;768;1001;1769
2020-08-05;BU;70-79;428;423;851
2020-08-05;PA;70-79;204;224;428
2020-08-05;VA;70-79;575;655;1230
2020-08-05;ZA;70-79;161;154;315
2020-08-05;CyL;70-79;3424;3503;6927
2020-08-05;SO;>80;380;656;1036
2020-08-05;CyL;>80;4641;8164;12805
2020-08-04;AV;0-9;137;122;259
2020-08-04;BU;0-9;297;214;511
2020-08-04;LE;0-9;280;249;529
2020-08-04;PA;0-9;92;55;147
2020-08-04;SA;0-9;303;343;646
2020-08-04;SO;0-9;92;76;168
2020-08-04;CyL;0-9;2104;1868;3972
2020-08-04;BU;20-29;456;573;1029
2020-08-04;SO;20-29;161;229;390
2020-08-04;VA;20-29;537;737;1274
2020-08-04;CyL;20-29;2648;3532;6180
2020-08-04;AV;30-39;288;401;689
2020-08-04;BU;30-39;701;923;1624
2020-08-04;SO;30-39;208;327;535
2020-08-04;ZA;30-39;140;220;360
2020-08-04;CyL;30-39;4014;5845;9859
2020-08-04;LE;40-49;862;1348;2210
2020-08-04;SE;40-49;594;894;1488
2020-08-04;CyL;40-49;5785;8310;14095
2020-08-04;LE;50-59;878;1327;2205
2020-08-04;SA;50-59;986;1492;2478
2020-08-04;VA;50-59;964;1497;2461
2020-08-04;LE;60-69;764;958;1722
2020-08-04;SA;60-69;756;915;1671
2020-08-04;CyL;60-69;4660;5683;10343
2020-08-04;SE;70-79;422;418;840
2020-08-04;SO;70-79;182;169;351
2020-08-04;CyL;70-79;3413;3489;6902
2020-08-04;AV;>80;402;649;1051
2020-08-04;PA;>80;221;424;645
2020-08-04;SA;>80;756;1332;2088
2020-08-04;SE;>80;628;1012;1640
2020-08-04;SO;>80;378;650;1028
2020-08-04;ZA;>80;223;349;572
2020-08-04;VA;0-9;501;439;940
2020-08-04;AV;10-19;131;99;230
2020-08-04;BU;10-19;268;256;524
2020-08-04;LE;10-19;222;220;442
2020-08-04;PA;10-19;102;89;191
2020-08-04;SA;10-19;232;248;480
2020-08-04;SO;10-19;79;77;156
2020-08-04;VA;10-19;337;342;679
2020-08-04;ZA;10-19;77;89;166
2020-08-04;CyL;10-19;1585;1562;3147
2020-08-04;AV;20-29;176;227;403
2020-08-04;SA;20-29;425;580;1005
2020-08-04;SE;20-29;251;370;621
2020-08-04;LE;30-39;596;949;1545
2020-08-04;PA;30-39;255;337;592
2020-08-04;SA;30-39;639;945;1584
2020-08-04;VA;30-39;817;1196;2013
2020-08-04;BU;40-49;1028;1280;2308
2020-08-04;PA;40-49;367;464;831
2020-08-04;PA;50-59;356;500;856
2020-08-04;ZA;50-59;244;382;626
2020-08-04;PA;60-69;303;338;641
2020-08-04;SO;60-69;266;345;611
2020-08-04;VA;60-69;764;998;1762
2020-08-04;ZA;60-69;226;260;486
2020-08-04;AV;70-79;277;302;579
2020-08-04;LE;70-79;644;575;1219
2020-08-04;PA;70-79;204;224;428
2020-08-04;SA;70-79;525;578;1103
2020-08-04;VA;70-79;574;651;1225
2020-08-04;VA;>80;667;1346;2013
2020-08-04;SE;0-9;189;166;355
2020-08-04;ZA;0-9;213;204;417
2020-08-04;SE;10-19;137;142;279
2020-08-04;LE;20-29;387;499;886
2020-08-04;PA;20-29;166;199;365
2020-08-04;ZA;20-29;89;118;207
2020-08-04;SE;30-39;370;547;917
2020-08-04;AV;40-49;424;606;1030
2020-08-04;SA;40-49;845;1224;2069
2020-08-04;SO;40-49;305;498;803
2020-08-04;VA;40-49;1142;1665;2807
2020-08-04;ZA;40-49;218;331;549
2020-08-04;AV;50-59;410;672;1082
2020-08-04;BU;50-59;889;1290;2179
2020-08-04;SE;50-59;745;1178;1923
2020-08-04;SO;50-59;354;588;942
2020-08-04;CyL;50-59;5826;8926;14752
2020-08-04;AV;60-69;371;442;813
2020-08-04;BU;60-69;601;739;1340
2020-08-04;SE;60-69;609;688;1297
2020-08-04;BU;70-79;424;418;842
2020-08-04;ZA;70-79;161;154;315
2020-08-04;BU;>80;573;999;1572
2020-08-04;LE;>80;783;1377;2160
2020-08-04;CyL;>80;4631;8138;12769
2020-08-03;BU;0-9;281;206;487
2020-08-03;LE;0-9;278;247;525
2020-08-03;CyL;0-9;2079;1839;3918
2020-08-03;VA;10-19;332;340;672
2020-08-03;SE;20-29;247;368;615
2020-08-03;VA;20-29;530;733;1263
2020-08-03;CyL;20-29;2612;3507;6119
2020-08-03;AV;30-39;288;401;689
2020-08-03;LE;30-39;597;946;1543
2020-08-03;SE;30-39;369;545;914
2020-08-03;AV;40-49;421;605;1026
2020-08-03;VA;40-49;1142;1658;2800
2020-08-03;ZA;40-49;218;331;549
2020-08-03;CyL;40-49;5753;8282;14035
2020-08-03;PA;50-59;356;500;856
2020-08-03;LE;60-69;761;957;1718
2020-08-03;SA;60-69;753;913;1666
2020-08-03;SO;60-69;265;343;608
2020-08-03;VA;60-69;761;994;1755
2020-08-03;ZA;70-79;161;154;315
2020-08-03;BU;>80;572;999;1571
2020-08-03;SO;>80;377;648;1025
2020-08-03;AV;0-9;137;121;258
2020-08-03;SA;0-9;300;340;640
2020-08-03;SE;0-9;191;163;354
2020-08-03;SO;0-9;89;74;163
2020-08-03;ZA;0-9;213;202;415
2020-08-03;AV;10-19;131;99;230
2020-08-03;BU;10-19;261;248;509
2020-08-03;LE;10-19;219;218;437
2020-08-03;ZA;10-19;77;88;165
2020-08-03;CyL;10-19;1560;1542;3102
2020-08-03;AV;20-29;176;226;402
2020-08-03;BU;20-29;443;564;1007
2020-08-03;LE;20-29;386;498;884
2020-08-03;ZA;20-29;90;118;208
2020-08-03;BU;30-39;695;909;1604
2020-08-03;SO;30-39;204;327;531
2020-08-03;ZA;30-39;140;219;359
2020-08-03;BU;40-49;1014;1271;2285
2020-08-03;LE;40-49;861;1345;2206
2020-08-03;PA;40-49;367;464;831
2020-08-03;SE;40-49;589;890;1479
2020-08-03;AV;50-59;410;672;1082
2020-08-03;BU;50-59;886;1285;2171
2020-08-03;AV;60-69;371;442;813
2020-08-03;PA;60-69;301;337;638
2020-08-03;ZA;60-69;226;260;486
2020-08-03;CyL;60-69;4644;5668;10312
2020-08-03;AV;70-79;277;301;578
2020-08-03;PA;70-79;204;224;428
2020-08-03;VA;70-79;572;651;1223
2020-08-03;CyL;70-79;3406;3480;6886
2020-08-03;AV;>80;402;649;1051
2020-08-03;LE;>80;781;1376;2157
2020-08-03;PA;>80;222;425;647
2020-08-03;SE;>80;629;1013;1642
2020-08-03;ZA;>80;223;349;572
2020-08-03;PA;0-9;90;53;143
2020-08-03;VA;0-9;500;433;933
2020-08-03;PA;10-19;98;86;184
2020-08-03;SA;10-19;229;248;477
2020-08-03;SE;10-19;136;141;277
2020-08-03;SO;10-19;77;74;151
2020-08-03;PA;20-29;164;197;361
2020-08-03;SA;20-29;416;577;993
2020-08-03;SO;20-29;160;226;386
2020-08-03;PA;30-39;256;337;593
2020-08-03;SA;30-39;634;939;1573
2020-08-03;VA;30-39;813;1193;2006
2020-08-03;CyL;30-39;3996;5816;9812
2020-08-03;SA;40-49;841;1221;2062
2020-08-03;SO;40-49;300;497;797
2020-08-03;LE;50-59;878;1325;2203
2020-08-03;SA;50-59;985;1491;2476
2020-08-03;SE;50-59;743;1176;1919
2020-08-03;SO;50-59;352;589;941
2020-08-03;VA;50-59;960;1495;2455
2020-08-03;ZA;50-59;244;382;626
2020-08-03;CyL;50-59;5814;8915;14729
2020-08-03;BU;60-69;598;734;1332
2020-08-03;SE;60-69;608;688;1296
2020-08-03;BU;70-79;419;413;832
2020-08-03;LE;70-79;644;574;1218
2020-08-03;SA;70-79;525;577;1102
2020-08-03;SE;70-79;422;418;840
2020-08-03;SO;70-79;182;168;350
2020-08-03;SA;>80;754;1332;2086
2020-08-03;VA;>80;667;1345;2012
2020-08-03;CyL;>80;4627;8136;12763
2020-08-02;AV;0-9;136;120;256
2020-08-02;LE;0-9;274;248;522
2020-08-02;ZA;0-9;213;202;415
2020-08-02;CyL;0-9;2061;1832;3893
2020-08-02;AV;10-19;130;99;229
2020-08-02;BU;10-19;256;242;498
2020-08-02;CyL;10-19;1549;1527;3076
2020-08-02;AV;20-29;175;226;401
2020-08-02;PA;20-29;163;198;361
2020-08-02;SO;20-29;160;226;386
2020-08-02;LE;30-39;594;945;1539
2020-08-02;VA;30-39;808;1191;1999
2020-08-02;CyL;30-39;3979;5794;9773
2020-08-02;LE;40-49;861;1345;2206
2020-08-02;VA;40-49;1140;1657;2797
2020-08-02;CyL;40-49;5741;8272;14013
2020-08-02;CyL;50-59;5799;8899;14698
2020-08-02;LE;60-69;760;954;1714
2020-08-02;SA;60-69;751;910;1661
2020-08-02;SA;70-79;522;574;1096
2020-08-02;SO;70-79;180;167;347
2020-08-02;ZA;70-79;161;154;315
2020-08-02;AV;>80;402;648;1050
2020-08-02;BU;>80;571;995;1566
2020-08-02;SE;>80;630;1012;1642
2020-08-02;ZA;>80;223;348;571
2020-08-02;BU;0-9;275;197;472
2020-08-02;SA;0-9;298;339;637
2020-08-02;SE;0-9;187;161;348
2020-08-02;VA;0-9;501;437;938
2020-08-02;LE;10-19;216;215;431
2020-08-02;PA;10-19;99;86;185
2020-08-02;SE;10-19;136;137;273
2020-08-02;VA;10-19;332;340;672
2020-08-02;ZA;10-19;77;88;165
2020-08-02;SE;20-29;245;368;613
2020-08-02;VA;20-29;526;730;1256
2020-08-02;AV;30-39;288;401;689
2020-08-02;SE;30-39;367;541;908
2020-08-02;SO;30-39;202;323;525
2020-08-02;PA;40-49;368;463;831
2020-08-02;SE;40-49;588;888;1476
2020-08-02;SO;40-49;300;499;799
2020-08-02;ZA;40-49;217;332;549
2020-08-02;LE;50-59;875;1323;2198
2020-08-02;SO;50-59;351;584;935
2020-08-02;VA;50-59;960;1491;2451
2020-08-02;PA;60-69;305;336;641
2020-08-02;SE;60-69;609;686;1295
2020-08-02;CyL;60-69;4639;5650;10289
2020-08-02;AV;70-79;277;299;576
2020-08-02;BU;70-79;417;411;828
2020-08-02;LE;70-79;642;573;1215
2020-08-02;PA;70-79;202;224;426
2020-08-02;SE;70-79;419;416;835
2020-08-02;VA;70-79;572;650;1222
2020-08-02;CyL;70-79;3392;3468;6860
2020-08-02;PA;>80;222;424;646
2020-08-02;SA;>80;755;1331;2086
2020-08-02;VA;>80;664;1344;2008
2020-08-02;PA;0-9;89;54;143
2020-08-02;SO;0-9;88;74;162
2020-08-02;SA;10-19;226;247;473
2020-08-02;SO;10-19;77;73;150
2020-08-02;BU;20-29;439;558;997
2020-08-02;LE;20-29;384;495;879
2020-08-02;SA;20-29;416;566;982
2020-08-02;ZA;20-29;89;117;206
2020-08-02;CyL;20-29;2597;3484;6081
2020-08-02;BU;30-39;693;902;1595
2020-08-02;PA;30-39;256;337;593
2020-08-02;SA;30-39;632;936;1568
2020-08-02;ZA;30-39;139;218;357
2020-08-02;AV;40-49;420;604;1024
2020-08-02;BU;40-49;1006;1266;2272
2020-08-02;SA;40-49;841;1218;2059
2020-08-02;AV;50-59;410;670;1080
2020-08-02;BU;50-59;877;1282;2159
2020-08-02;PA;50-59;356;500;856
2020-08-02;SA;50-59;984;1491;2475
2020-08-02;SE;50-59;742;1176;1918
2020-08-02;ZA;50-59;244;382;626
2020-08-02;AV;60-69;371;443;814
2020-08-02;BU;60-69;593;730;1323
2020-08-02;SO;60-69;265;341;606
2020-08-02;VA;60-69;759;990;1749
2020-08-02;ZA;60-69;226;260;486
2020-08-02;LE;>80;780;1375;2155
2020-08-02;SO;>80;375;648;1023
2020-08-02;CyL;>80;4622;8125;12747
2020-07-30;AV;0-9;136;120;256
2020-07-30;SA;0-9;294;332;626
2020-07-30;SE;0-9;187;158;345
2020-07-30;SO;0-9;83;67;150
2020-07-30;VA;0-9;497;436;933
2020-07-30;SA;10-19;226;242;468
2020-07-30;ZA;10-19;77;87;164
2020-07-30;AV;20-29;175;226;401
2020-07-30;SO;20-29;155;222;377
2020-07-30;CyL;20-29;2583;3440;6023
2020-07-30;BU;30-39;679;892;1571
2020-07-30;PA;30-39;255;336;591
2020-07-30;SA;30-39;622;930;1552
2020-07-30;SE;30-39;366;542;908
2020-07-30;SO;30-39;196;312;508
2020-07-30;CyL;30-39;3939;5763;9702
2020-07-30;SA;40-49;838;1216;2054
2020-07-30;SE;40-49;589;884;1473
2020-07-30;CyL;40-49;5705;8239;13944
2020-07-30;AV;50-59;409;669;1078
2020-07-30;SA;50-59;981;1486;2467
2020-07-30;ZA;50-59;242;380;622
2020-07-30;LE;60-69;759;951;1710
2020-07-30;SO;60-69;264;340;604
2020-07-30;ZA;60-69;226;259;485
2020-07-30;LE;70-79;643;573;1216
2020-07-30;AV;>80;402;645;1047
2020-07-30;BU;>80;570;992;1562
2020-07-30;PA;>80;221;423;644
2020-07-30;CyL;>80;4607;8101;12708
2020-07-30;BU;0-9;276;192;468
2020-07-30;BU;10-19;247;228;475
2020-07-30;PA;10-19;98;85;183
2020-07-30;SE;10-19;135;131;266
2020-07-30;SO;10-19;72;71;143
2020-07-30;CyL;10-19;1530;1496;3026
2020-07-30;BU;20-29;436;547;983
2020-07-30;VA;20-29;521;725;1246
2020-07-30;AV;30-39;288;401;689
2020-07-30;ZA;30-39;136;216;352
2020-07-30;AV;40-49;420;602;1022
2020-07-30;BU;40-49;989;1259;2248
2020-07-30;SO;40-49;297;494;791
2020-07-30;SE;50-59;739;1173;1912
2020-07-30;SO;50-59;349;583;932
2020-07-30;CyL;50-59;5784;8876;14660
2020-07-30;AV;60-69;370;442;812
2020-07-30;SA;60-69;747;908;1655
2020-07-30;VA;60-69;758;989;1747
2020-07-30;CyL;60-69;4624;5636;10260
2020-07-30;SA;70-79;517;571;1088
2020-07-30;SE;70-79;415;411;826
2020-07-30;ZA;70-79;159;153;312
2020-07-30;SE;>80;627;1009;1636
2020-07-30;LE;0-9;272;246;518
2020-07-30;PA;0-9;88;53;141
2020-07-30;ZA;0-9;211;200;411
2020-07-30;CyL;0-9;2044;1804;3848
2020-07-30;AV;10-19;130;99;229
2020-07-30;LE;10-19;215;214;429
2020-07-30;VA;10-19;330;339;669
2020-07-30;LE;20-29;385;492;877
2020-07-30;PA;20-29;163;197;360
2020-07-30;SA;20-29;414;555;969
2020-07-30;SE;20-29;245;362;607
2020-07-30;ZA;20-29;89;114;203
2020-07-30;LE;30-39;593;948;1541
2020-07-30;VA;30-39;804;1186;1990
2020-07-30;LE;40-49;859;1345;2204
2020-07-30;PA;40-49;365;461;826
2020-07-30;VA;40-49;1132;1648;2780
2020-07-30;ZA;40-49;216;330;546
2020-07-30;BU;50-59;874;1272;2146
2020-07-30;LE;50-59;875;1322;2197
2020-07-30;PA;50-59;356;500;856
2020-07-30;VA;50-59;959;1491;2450
2020-07-30;BU;60-69;590;728;1318
2020-07-30;PA;60-69;302;335;637
2020-07-30;SE;60-69;608;684;1292
2020-07-30;AV;70-79;277;298;575
2020-07-30;BU;70-79;414;407;821
2020-07-30;PA;70-79;200;223;423
2020-07-30;SO;70-79;176;166;342
2020-07-30;VA;70-79;571;648;1219
2020-07-30;CyL;70-79;3372;3450;6822
2020-07-30;LE;>80;779;1373;2152
2020-07-30;SA;>80;749;1324;2073
2020-07-30;SO;>80;372;645;1017
2020-07-30;VA;>80;664;1345;2009
2020-07-30;ZA;>80;223;345;568
2020-07-29;PA;0-9;88;51;139
2020-07-29;SA;0-9;293;329;622
2020-07-29;SE;0-9;184;156;340
2020-07-29;SA;10-19;224;240;464
2020-07-29;VA;10-19;328;333;661
2020-07-29;ZA;10-19;77;87;164
2020-07-29;LE;20-29;385;492;877
2020-07-29;SA;20-29;412;555;967
2020-07-29;SE;20-29;249;361;610
2020-07-29;SO;20-29;154;217;371
2020-07-29;PA;30-39;254;335;589
2020-07-29;SE;30-39;366;540;906
2020-07-29;VA;30-39;799;1183;1982
2020-07-29;AV;40-49;419;602;1021
2020-07-29;PA;40-49;366;460;826
2020-07-29;VA;40-49;1127;1646;2773
2020-07-29;LE;50-59;873;1318;2191
2020-07-29;SA;50-59;980;1487;2467
2020-07-29;VA;50-59;956;1485;2441
2020-07-29;CyL;50-59;5774;8859;14633
2020-07-29;VA;60-69;752;985;1737
2020-07-29;AV;70-79;277;298;575
2020-07-29;LE;70-79;640;572;1212
2020-07-29;SA;70-79;516;571;1087
2020-07-29;VA;70-79;569;648;1217
2020-07-29;SO;>80;372;644;1016
2020-07-29;ZA;>80;222;345;567
2020-07-29;CyL;>80;4603;8092;12695
2020-07-29;LE;0-9;269;241;510
2020-07-29;ZA;0-9;211;199;410
2020-07-29;AV;10-19;129;98;227
2020-07-29;LE;10-19;215;214;429
2020-07-29;SO;10-19;72;70;142
2020-07-29;CyL;10-19;1518;1487;3005
2020-07-29;AV;20-29;176;226;402
2020-07-29;BU;20-29;436;543;979
2020-07-29;BU;30-39;676;892;1568
2020-07-29;LE;30-39;589;948;1537
2020-07-29;SO;30-39;194;311;505
2020-07-29;ZA;30-39;135;214;349
2020-07-29;LE;40-49;860;1343;2203
2020-07-29;SA;40-49;838;1217;2055
2020-07-29;BU;50-59;874;1271;2145
2020-07-29;SE;50-59;737;1169;1906
2020-07-29;SO;50-59;348;582;930
2020-07-29;BU;60-69;592;726;1318
2020-07-29;SA;60-69;746;909;1655
2020-07-29;SE;60-69;610;683;1293
2020-07-29;SO;60-69;263;339;602
2020-07-29;CyL;60-69;4618;5626;10244
2020-07-29;BU;70-79;415;407;822
2020-07-29;SE;70-79;413;411;824
2020-07-29;BU;>80;570;993;1563
2020-07-29;PA;>80;221;423;644
2020-07-29;VA;>80;662;1344;2006
2020-07-29;AV;0-9;135;119;254
2020-07-29;BU;0-9;272;188;460
2020-07-29;SO;0-9;83;66;149
2020-07-29;VA;0-9;495;433;928
2020-07-29;CyL;0-9;2030;1782;3812
2020-07-29;BU;10-19;242;230;472
2020-07-29;PA;10-19;98;85;183
2020-07-29;SE;10-19;133;130;263
2020-07-29;PA;20-29;162;198;360
2020-07-29;VA;20-29;517;718;1235
2020-07-29;ZA;20-29;89;113;202
2020-07-29;CyL;20-29;2580;3423;6003
2020-07-29;AV;30-39;288;401;689
2020-07-29;SA;30-39;619;932;1551
2020-07-29;CyL;30-39;3920;5756;9676
2020-07-29;BU;40-49;980;1253;2233
2020-07-29;SE;40-49;588;882;1470
2020-07-29;SO;40-49;291;490;781
2020-07-29;ZA;40-49;216;330;546
2020-07-29;CyL;40-49;5685;8223;13908
2020-07-29;AV;50-59;409;668;1077
2020-07-29;PA;50-59;355;499;854
2020-07-29;ZA;50-59;242;380;622
2020-07-29;AV;60-69;371;442;813
2020-07-29;LE;60-69;758;948;1706
2020-07-29;PA;60-69;301;335;636
2020-07-29;ZA;60-69;225;259;484
2020-07-29;PA;70-79;199;222;421
2020-07-29;SO;70-79;176;166;342
2020-07-29;ZA;70-79;159;153;312
2020-07-29;CyL;70-79;3364;3448;6812
2020-07-29;AV;>80;402;645;1047
2020-07-29;LE;>80;778;1372;2150
2020-07-29;SA;>80;751;1322;2073
2020-07-29;SE;>80;625;1004;1629
2020-07-28;AV;0-9;135;119;254
2020-07-28;LE;0-9;268;240;508
2020-07-28;SA;0-9;295;329;624
2020-07-28;SE;0-9;182;157;339
2020-07-28;SO;0-9;83;65;148
2020-07-28;VA;0-9;492;428;920
2020-07-28;AV;10-19;130;98;228
2020-07-28;SO;10-19;72;68;140
2020-07-28;VA;10-19;328;331;659
2020-07-28;LE;20-29;383;490;873
2020-07-28;SO;20-29;154;216;370
2020-07-28;VA;20-29;513;714;1227
2020-07-28;SE;30-39;365;540;905
2020-07-28;VA;30-39;796;1181;1977
2020-07-28;ZA;30-39;135;214;349
2020-07-28;AV;40-49;419;601;1020
2020-07-28;SA;50-59;981;1487;2468
2020-07-28;SE;50-59;736;1169;1905
2020-07-28;BU;60-69;592;724;1316
2020-07-28;LE;60-69;758;945;1703
2020-07-28;PA;60-69;301;334;635
2020-07-28;SO;60-69;262;338;600
2020-07-28;AV;>80;401;643;1044
2020-07-28;LE;>80;774;1372;2146
2020-07-28;PA;>80;221;423;644
2020-07-28;SO;>80;372;644;1016
2020-07-28;ZA;>80;222;345;567
2020-07-28;ZA;0-9;209;197;406
2020-07-28;CyL;0-9;2017;1772;3789
2020-07-28;BU;10-19;236;229;465
2020-07-28;PA;10-19;98;84;182
2020-07-28;SE;10-19;135;129;264
2020-07-28;CyL;10-19;1514;1478;2992
2020-07-28;AV;20-29;176;226;402
2020-07-28;BU;30-39;673;891;1564
2020-07-28;PA;30-39;254;334;588
2020-07-28;SA;30-39;615;927;1542
2020-07-28;SO;30-39;194;310;504
2020-07-28;CyL;30-39;3908;5745;9653
2020-07-28;BU;40-49;974;1254;2228
2020-07-28;LE;40-49;860;1343;2203
2020-07-28;SA;40-49;837;1217;2054
2020-07-28;SO;40-49;290;487;777
2020-07-28;VA;40-49;1126;1646;2772
2020-07-28;CyL;40-49;5672;8218;13890
2020-07-28;LE;50-59;872;1317;2189
2020-07-28;VA;50-59;956;1484;2440
2020-07-28;CyL;50-59;5766;8844;14610
2020-07-28;SA;60-69;744;905;1649
2020-07-28;SE;60-69;608;680;1288
2020-07-28;VA;60-69;749;983;1732
2020-07-28;ZA;60-69;225;259;484
2020-07-28;LE;70-79;640;572;1212
2020-07-28;PA;70-79;198;222;420
2020-07-28;SE;70-79;413;411;824
2020-07-28;VA;70-79;568;649;1217
2020-07-28;VA;>80;662;1344;2006
2020-07-28;CyL;>80;4594;8081;12675
2020-07-28;BU;0-9;268;187;455
2020-07-28;PA;0-9;85;50;135
2020-07-28;LE;10-19;214;214;428
2020-07-28;SA;10-19;224;238;462
2020-07-28;ZA;10-19;77;87;164
2020-07-28;BU;20-29;433;539;972
2020-07-28;PA;20-29;162;196;358
2020-07-28;SA;20-29;414;552;966
2020-07-28;SE;20-29;247;360;607
2020-07-28;ZA;20-29;89;113;202
2020-07-28;CyL;20-29;2571;3406;5977
2020-07-28;AV;30-39;288;399;687
2020-07-28;LE;30-39;588;949;1537
2020-07-28;PA;40-49;365;461;826
2020-07-28;SE;40-49;585;879;1464
2020-07-28;ZA;40-49;216;330;546
2020-07-28;AV;50-59;408;665;1073
2020-07-28;BU;50-59;870;1268;2138
2020-07-28;PA;50-59;355;495;850
2020-07-28;SO;50-59;346;580;926
2020-07-28;ZA;50-59;242;379;621
2020-07-28;AV;60-69;370;441;811
2020-07-28;CyL;60-69;4609;5609;10218
2020-07-28;AV;70-79;277;298;575
2020-07-28;BU;70-79;417;407;824
2020-07-28;SA;70-79;516;571;1087
2020-07-28;SO;70-79;176;165;341
2020-07-28;ZA;70-79;159;153;312
2020-07-28;CyL;70-79;3364;3448;6812
2020-07-28;BU;>80;569;990;1559
2020-07-28;SA;>80;749;1321;2070
2020-07-28;SE;>80;624;999;1623
2020-07-27;LE;0-9;267;240;507
2020-07-27;PA;0-9;86;50;136
2020-07-27;SE;0-9;183;157;340
2020-07-27;VA;0-9;493;427;920
2020-07-27;CyL;0-9;2008;1764;3772
2020-07-27;SA;10-19;223;237;460
2020-07-27;SO;10-19;71;68;139
2020-07-27;PA;20-29;165;194;359
2020-07-27;SA;20-29;411;551;962
2020-07-27;SE;20-29;244;359;603
2020-07-27;CyL;20-29;2566;3390;5956
2020-07-27;SE;30-39;362;539;901
2020-07-27;AV;40-49;418;602;1020
2020-07-27;BU;40-49;973;1250;2223
2020-07-27;PA;40-49;364;461;825
2020-07-27;LE;50-59;870;1315;2185
2020-07-27;PA;50-59;355;493;848
2020-07-27;SE;50-59;735;1169;1904
2020-07-27;ZA;50-59;242;379;621
2020-07-27;CyL;50-59;5760;8828;14588
2020-07-27;LE;60-69;755;945;1700
2020-07-27;SE;60-69;606;679;1285
2020-07-27;BU;70-79;416;405;821
2020-07-27;LE;70-79;638;570;1208
2020-07-27;SA;70-79;516;570;1086
2020-07-27;SE;70-79;410;411;821
2020-07-27;VA;70-79;569;650;1219
2020-07-27;ZA;70-79;159;153;312
2020-07-27;CyL;70-79;3358;3442;6800
2020-07-27;AV;>80;400;643;1043
2020-07-27;VA;>80;662;1345;2007
2020-07-27;CyL;>80;4593;8078;12671
2020-07-27;AV;0-9;134;119;253
2020-07-27;BU;0-9;261;184;445
2020-07-27;SA;0-9;293;327;620
2020-07-27;SO;0-9;82;64;146
2020-07-27;AV;10-19;128;98;226
2020-07-27;LE;10-19;214;213;427
2020-07-27;ZA;10-19;77;87;164
2020-07-27;SO;20-29;154;215;369
2020-07-27;VA;20-29;513;711;1224
2020-07-27;AV;30-39;288;400;688
2020-07-27;PA;30-39;252;331;583
2020-07-27;SO;30-39;194;309;503
2020-07-27;VA;30-39;795;1179;1974
2020-07-27;ZA;30-39;135;214;349
2020-07-27;CyL;30-39;3892;5731;9623
2020-07-27;LE;40-49;857;1340;2197
2020-07-27;AV;50-59;408;663;1071
2020-07-27;SO;50-59;346;580;926
2020-07-27;BU;60-69;589;721;1310
2020-07-27;PA;60-69;302;335;637
2020-07-27;ZA;60-69;225;259;484
2020-07-27;CyL;60-69;4601;5602;10203
2020-07-27;LE;>80;773;1371;2144
2020-07-27;PA;>80;221;422;643
2020-07-27;SE;>80;625;997;1622
2020-07-27;SO;>80;372;644;1016
2020-07-27;ZA;0-9;209;196;405
2020-07-27;BU;10-19;233;229;462
2020-07-27;PA;10-19;97;83;180
2020-07-27;SE;10-19;133;130;263
2020-07-27;VA;10-19;325;331;656
2020-07-27;CyL;10-19;1501;1476;2977
2020-07-27;AV;20-29;176;223;399
2020-07-27;BU;20-29;432;537;969
2020-07-27;LE;20-29;382;487;869
2020-07-27;ZA;20-29;89;113;202
2020-07-27;BU;30-39;668;889;1557
2020-07-27;LE;30-39;583;947;1530
2020-07-27;SA;30-39;615;923;1538
2020-07-27;SA;40-49;836;1215;2051
2020-07-27;SE;40-49;583;877;1460
2020-07-27;SO;40-49;290;487;777
2020-07-27;VA;40-49;1125;1645;2770
2020-07-27;ZA;40-49;217;330;547
2020-07-27;CyL;40-49;5663;8207;13870
2020-07-27;BU;50-59;868;1263;2131
2020-07-27;SA;50-59;982;1486;2468
2020-07-27;VA;50-59;954;1480;2434
2020-07-27;AV;60-69;370;440;810
2020-07-27;SA;60-69;744;905;1649
2020-07-27;SO;60-69;262;337;599
2020-07-27;VA;60-69;748;981;1729
2020-07-27;AV;70-79;276;297;573
2020-07-27;PA;70-79;198;220;418
2020-07-27;SO;70-79;176;166;342
2020-07-27;BU;>80;569;990;1559
2020-07-27;SA;>80;749;1321;2070
2020-07-27;ZA;>80;222;345;567
2020-07-26;AV;0-9;134;121;255
2020-07-26;LE;0-9;268;239;507
2020-07-26;SA;0-9;294;327;621
2020-07-26;SE;0-9;180;155;335
2020-07-26;BU;10-19;231;223;454
2020-07-26;SE;20-29;242;357;599
2020-07-26;ZA;20-29;88;113;201
2020-07-26;CyL;20-29;2554;3383;5937
2020-07-26;PA;30-39;251;331;582
2020-07-26;SA;30-39;614;923;1537
2020-07-26;SO;30-39;194;308;502
2020-07-26;AV;40-49;418;601;1019
2020-07-26;SE;40-49;584;875;1459
2020-07-26;AV;50-59;407;663;1070
2020-07-26;BU;50-59;864;1261;2125
2020-07-26;LE;50-59;869;1314;2183
2020-07-26;SE;50-59;733;1169;1902
2020-07-26;VA;50-59;952;1476;2428
2020-07-26;CyL;50-59;5747;8815;14562
2020-07-26;LE;60-69;752;945;1697
2020-07-26;SA;60-69;744;904;1648
2020-07-26;VA;60-69;745;982;1727
2020-07-26;CyL;60-69;4590;5604;10194
2020-07-26;SO;70-79;176;164;340
2020-07-26;AV;>80;400;643;1043
2020-07-26;BU;>80;569;988;1557
2020-07-26;PA;>80;220;423;643
2020-07-26;SA;>80;749;1319;2068
2020-07-26;SO;>80;372;644;1016
2020-07-26;PA;0-9;85;50;135
2020-07-26;SO;0-9;82;63;145
2020-07-26;ZA;0-9;209;196;405
2020-07-26;CyL;0-9;2003;1765;3768
2020-07-26;AV;10-19;128;97;225
2020-07-26;LE;10-19;213;213;426
2020-07-26;PA;10-19;98;82;180
2020-07-26;SA;10-19;222;237;459
2020-07-26;VA;10-19;323;331;654
2020-07-26;CyL;10-19;1492;1464;2956
2020-07-26;AV;20-29;176;223;399
2020-07-26;PA;20-29;165;193;358
2020-07-26;SA;20-29;408;548;956
2020-07-26;SO;20-29;153;214;367
2020-07-26;BU;30-39;664;887;1551
2020-07-26;LE;30-39;584;944;1528
2020-07-26;SE;30-39;362;539;901
2020-07-26;VA;30-39;791;1177;1968
2020-07-26;ZA;30-39;136;214;350
2020-07-26;CyL;30-39;3884;5723;9607
2020-07-26;BU;40-49;973;1244;2217
2020-07-26;SA;40-49;837;1216;2053
2020-07-26;ZA;40-49;217;330;547
2020-07-26;CyL;40-49;5662;8194;13856
2020-07-26;SO;50-59;346;578;924
2020-07-26;ZA;50-59;242;378;620
2020-07-26;AV;60-69;369;440;809
2020-07-26;BU;60-69;586;724;1310
2020-07-26;PA;60-69;303;335;638
2020-07-26;ZA;60-69;225;259;484
2020-07-26;BU;70-79;414;404;818
2020-07-26;PA;70-79;198;218;416
2020-07-26;SE;70-79;407;410;817
2020-07-26;VA;70-79;571;649;1220
2020-07-26;ZA;70-79;159;153;312
2020-07-26;ZA;>80;222;345;567
2020-07-26;CyL;>80;4592;8076;12668
2020-07-26;BU;0-9;256;186;442
2020-07-26;VA;0-9;495;428;923
2020-07-26;SE;10-19;131;127;258
2020-07-26;SO;10-19;70;67;137
2020-07-26;ZA;10-19;76;87;163
2020-07-26;BU;20-29;430;538;968
2020-07-26;LE;20-29;382;488;870
2020-07-26;VA;20-29;510;709;1219
2020-07-26;AV;30-39;288;400;688
2020-07-26;LE;40-49;857;1339;2196
2020-07-26;PA;40-49;364;461;825
2020-07-26;SO;40-49;290;487;777
2020-07-26;VA;40-49;1122;1641;2763
2020-07-26;PA;50-59;356;494;850
2020-07-26;SA;50-59;978;1482;2460
2020-07-26;SE;60-69;605;678;1283
2020-07-26;SO;60-69;261;337;598
2020-07-26;AV;70-79;276;297;573
2020-07-26;LE;70-79;636;569;1205
2020-07-26;SA;70-79;514;569;1083
2020-07-26;CyL;70-79;3351;3433;6784
2020-07-26;LE;>80;774;1370;2144
2020-07-26;SE;>80;625;998;1623
2020-07-26;VA;>80;661;1346;2007
2020-07-23;LE;0-9;268;238;506
2020-07-23;PA;0-9;83;50;133
2020-07-23;SA;0-9;292;325;617
2020-07-23;SE;0-9;170;153;323
2020-07-23;VA;0-9;495;427;922
2020-07-23;CyL;0-9;1987;1751;3738
2020-07-23;AV;10-19;128;97;225
2020-07-23;PA;10-19;97;80;177
2020-07-23;SE;10-19;129;125;254
2020-07-23;VA;10-19;322;329;651
2020-07-23;CyL;10-19;1478;1455;2933
2020-07-23;AV;20-29;176;220;396
2020-07-23;AV;30-39;287;399;686
2020-07-23;LE;30-39;576;937;1513
2020-07-23;PA;30-39;251;331;582
2020-07-23;SE;30-39;361;537;898
2020-07-23;VA;30-39;791;1171;1962
2020-07-23;PA;40-49;365;459;824
2020-07-23;ZA;40-49;217;331;548
2020-07-23;CyL;40-49;5646;8175;13821
2020-07-23;PA;50-59;355;491;846
2020-07-23;VA;50-59;952;1473;2425
2020-07-23;AV;60-69;368;439;807
2020-07-23;BU;60-69;587;726;1313
2020-07-23;LE;60-69;751;944;1695
2020-07-23;BU;70-79;413;402;815
2020-07-23;SE;70-79;405;409;814
2020-07-23;AV;>80;399;643;1042
2020-07-23;LE;>80;772;1368;2140
2020-07-23;SA;>80;749;1320;2069
2020-07-23;AV;0-9;134;118;252
2020-07-23;BU;0-9;254;181;435
2020-07-23;ZA;0-9;209;196;405
2020-07-23;LE;10-19;209;214;423
2020-07-23;SO;20-29;148;211;359
2020-07-23;VA;20-29;507;707;1214
2020-07-23;ZA;20-29;88;113;201
2020-07-23;CyL;20-29;2533;3357;5890
2020-07-23;BU;30-39;665;884;1549
2020-07-23;ZA;30-39;136;214;350
2020-07-23;CyL;30-39;3871;5700;9571
2020-07-23;SA;40-49;836;1216;2052
2020-07-23;SE;40-49;581;871;1452
2020-07-23;SO;40-49;287;486;773
2020-07-23;AV;50-59;408;662;1070
2020-07-23;SO;50-59;346;578;924
2020-07-23;CyL;50-59;5736;8804;14540
2020-07-23;PA;60-69;299;335;634
2020-07-23;SE;60-69;602;674;1276
2020-07-23;ZA;60-69;225;259;484
2020-07-23;CyL;60-69;4581;5592;10173
2020-07-23;AV;70-79;276;297;573
2020-07-23;LE;70-79;634;569;1203
2020-07-23;SA;70-79;512;570;1082
2020-07-23;SO;70-79;174;164;338
2020-07-23;VA;70-79;570;644;1214
2020-07-23;SE;>80;623;993;1616
2020-07-23;SO;>80;370;644;1014
2020-07-23;ZA;>80;221;345;566
2020-07-23;SO;0-9;82;63;145
2020-07-23;BU;10-19;227;221;448
2020-07-23;SA;10-19;222;237;459
2020-07-23;SO;10-19;68;65;133
2020-07-23;ZA;10-19;76;87;163
2020-07-23;BU;20-29;425;535;960
2020-07-23;LE;20-29;380;485;865
2020-07-23;PA;20-29;165;192;357
2020-07-23;SA;20-29;403;544;947
2020-07-23;SE;20-29;241;350;591
2020-07-23;SA;30-39;610;920;1530
2020-07-23;SO;30-39;194;307;501
2020-07-23;AV;40-49;418;600;1018
2020-07-23;BU;40-49;967;1244;2211
2020-07-23;LE;40-49;854;1335;2189
2020-07-23;VA;40-49;1121;1633;2754
2020-07-23;BU;50-59;860;1259;2119
2020-07-23;LE;50-59;867;1315;2182
2020-07-23;SA;50-59;975;1482;2457
2020-07-23;SE;50-59;731;1166;1897
2020-07-23;ZA;50-59;242;378;620
2020-07-23;SA;60-69;745;902;1647
2020-07-23;SO;60-69;261;336;597
2020-07-23;VA;60-69;743;977;1720
2020-07-23;PA;70-79;195;217;412
2020-07-23;ZA;70-79;159;153;312
2020-07-23;CyL;70-79;3338;3425;6763
2020-07-23;BU;>80;567;985;1552
2020-07-23;PA;>80;220;422;642
2020-07-23;VA;>80;662;1342;2004
2020-07-23;CyL;>80;4583;8062;12645
2020-07-22;SE;0-9;167;152;319
2020-07-22;SO;0-9;80;61;141
2020-07-22;VA;0-9;491;428;919
2020-07-22;ZA;0-9;209;196;405
2020-07-22;LE;10-19;208;214;422
2020-07-22;SE;10-19;129;124;253
2020-07-22;SO;10-19;66;64;130
2020-07-22;VA;10-19;323;325;648
2020-07-22;BU;20-29;426;531;957
2020-07-22;LE;20-29;375;485;860
2020-07-22;SO;20-29;147;210;357
2020-07-22;LE;30-39;575;935;1510
2020-07-22;SA;30-39;610;919;1529
2020-07-22;SO;30-39;191;306;497
2020-07-22;BU;40-49;966;1246;2212
2020-07-22;SA;40-49;834;1214;2048
2020-07-22;ZA;40-49;217;331;548
2020-07-22;AV;50-59;407;662;1069
2020-07-22;LE;50-59;868;1315;2183
2020-07-22;PA;50-59;356;490;846
2020-07-22;SA;50-59;974;1478;2452
2020-07-22;ZA;50-59;242;378;620
2020-07-22;AV;60-69;367;439;806
2020-07-22;LE;60-69;750;941;1691
2020-07-22;SA;60-69;745;900;1645
2020-07-22;AV;70-79;276;298;574
2020-07-22;PA;>80;221;423;644
2020-07-22;SA;>80;746;1317;2063
2020-07-22;ZA;>80;221;345;566
2020-07-22;CyL;>80;4576;8053;12629
2020-07-22;AV;0-9;134;118;252
2020-07-22;BU;0-9;254;184;438
2020-07-22;LE;0-9;267;238;505
2020-07-22;PA;0-9;82;50;132
2020-07-22;SA;0-9;292;327;619
2020-07-22;PA;10-19;96;80;176
2020-07-22;CyL;10-19;1470;1449;2919
2020-07-22;AV;20-29;175;219;394
2020-07-22;VA;20-29;502;705;1207
2020-07-22;ZA;20-29;88;113;201
2020-07-22;AV;30-39;287;398;685
2020-07-22;BU;30-39;663;882;1545
2020-07-22;VA;30-39;791;1166;1957
2020-07-22;CyL;30-39;3862;5687;9549
2020-07-22;AV;40-49;418;600;1018
2020-07-22;PA;40-49;365;461;826
2020-07-22;SO;40-49;287;485;772
2020-07-22;CyL;40-49;5640;8174;13814
2020-07-22;SE;50-59;730;1165;1895
2020-07-22;SO;50-59;345;576;921
2020-07-22;VA;50-59;951;1471;2422
2020-07-22;LE;70-79;632;568;1200
2020-07-22;SA;70-79;511;570;1081
2020-07-22;CyL;70-79;3334;3421;6755
2020-07-22;AV;>80;397;641;1038
2020-07-22;BU;>80;566;985;1551
2020-07-22;SE;>80;623;992;1615
2020-07-22;VA;>80;662;1339;2001
2020-07-22;CyL;0-9;1976;1754;3730
2020-07-22;AV;10-19;126;97;223
2020-07-22;BU;10-19;224;222;446
2020-07-22;SA;10-19;222;236;458
2020-07-22;ZA;10-19;76;87;163
2020-07-22;PA;20-29;165;190;355
2020-07-22;SA;20-29;401;543;944
2020-07-22;SE;20-29;239;350;589
2020-07-22;CyL;20-29;2518;3346;5864
2020-07-22;PA;30-39;251;333;584
2020-07-22;SE;30-39;359;535;894
2020-07-22;ZA;30-39;135;213;348
2020-07-22;LE;40-49;852;1335;2187
2020-07-22;SE;40-49;580;870;1450
2020-07-22;VA;40-49;1121;1632;2753
2020-07-22;BU;50-59;859;1260;2119
2020-07-22;CyL;50-59;5732;8795;14527
2020-07-22;BU;60-69;590;721;1311
2020-07-22;PA;60-69;298;333;631
2020-07-22;SE;60-69;599;674;1273
2020-07-22;SO;60-69;261;336;597
2020-07-22;VA;60-69;743;976;1719
2020-07-22;ZA;60-69;225;259;484
2020-07-22;CyL;60-69;4578;5579;10157
2020-07-22;BU;70-79;414;401;815
2020-07-22;PA;70-79;195;217;412
2020-07-22;SE;70-79;405;409;814
2020-07-22;SO;70-79;172;163;335
2020-07-22;VA;70-79;570;642;1212
2020-07-22;ZA;70-79;159;153;312
2020-07-22;LE;>80;772;1367;2139
2020-07-22;SO;>80;368;644;1012
2020-07-21;CyL;0-9;1967;1754;3721
2020-07-21;LE;10-19;208;214;422
2020-07-21;SE;10-19;128;124;252
2020-07-21;BU;20-29;427;529;956
2020-07-21;LE;20-29;371;485;856
2020-07-21;PA;20-29;162;189;351
2020-07-21;SA;20-29;398;543;941
2020-07-21;SO;20-29;146;209;355
2020-07-21;CyL;20-29;2500;3340;5840
2020-07-21;AV;30-39;286;397;683
2020-07-21;LE;30-39;572;934;1506
2020-07-21;AV;40-49;418;599;1017
2020-07-21;LE;40-49;852;1332;2184
2020-07-21;PA;40-49;363;460;823
2020-07-21;SA;40-49;832;1212;2044
2020-07-21;ZA;40-49;217;331;548
2020-07-21;PA;50-59;354;490;844
2020-07-21;SO;50-59;345;575;920
2020-07-21;ZA;50-59;242;378;620
2020-07-21;PA;60-69;297;332;629
2020-07-21;SE;60-69;597;674;1271
2020-07-21;SE;70-79;405;407;812
2020-07-21;SO;70-79;171;163;334
2020-07-21;LE;>80;770;1366;2136
2020-07-21;SA;>80;745;1317;2062
2020-07-21;SE;>80;622;991;1613
2020-07-21;VA;>80;660;1338;1998
2020-07-21;ZA;>80;221;345;566
2020-07-21;BU;0-9;253;186;439
2020-07-21;PA;0-9;82;51;133
2020-07-21;SE;0-9;170;152;322
2020-07-21;SO;0-9;79;61;140
2020-07-21;VA;0-9;486;426;912
2020-07-21;AV;10-19;126;97;223
2020-07-21;BU;10-19;225;221;446
2020-07-21;PA;10-19;96;78;174
2020-07-21;SA;10-19;222;236;458
2020-07-21;SO;10-19;67;62;129
2020-07-21;VA;10-19;322;324;646
2020-07-21;AV;20-29;174;219;393
2020-07-21;SA;30-39;610;917;1527
2020-07-21;SE;30-39;357;533;890
2020-07-21;VA;30-39;790;1165;1955
2020-07-21;SE;40-49;578;868;1446
2020-07-21;VA;40-49;1118;1632;2750
2020-07-21;AV;50-59;406;662;1068
2020-07-21;SE;50-59;730;1163;1893
2020-07-21;VA;50-59;950;1469;2419
2020-07-21;SA;60-69;745;899;1644
2020-07-21;SO;60-69;261;335;596
2020-07-21;VA;60-69;742;975;1717
2020-07-21;CyL;60-69;4572;5572;10144
2020-07-21;BU;70-79;413;401;814
2020-07-21;SA;70-79;510;568;1078
2020-07-21;CyL;70-79;3329;3413;6742
2020-07-21;AV;>80;397;641;1038
2020-07-21;BU;>80;567;985;1552
2020-07-21;SO;>80;368;645;1013
2020-07-21;AV;0-9;133;118;251
2020-07-21;LE;0-9;264;238;502
2020-07-21;SA;0-9;291;326;617
2020-07-21;ZA;0-9;209;196;405
2020-07-21;ZA;10-19;76;87;163
2020-07-21;CyL;10-19;1470;1443;2913
2020-07-21;SE;20-29;236;350;586
2020-07-21;VA;20-29;499;703;1202
2020-07-21;ZA;20-29;87;113;200
2020-07-21;BU;30-39;661;880;1541
2020-07-21;PA;30-39;251;334;585
2020-07-21;SO;30-39;191;305;496
2020-07-21;ZA;30-39;135;213;348
2020-07-21;CyL;30-39;3853;5678;9531
2020-07-21;BU;40-49;968;1243;2211
2020-07-21;SO;40-49;287;485;772
2020-07-21;CyL;40-49;5633;8162;13795
2020-07-21;BU;50-59;857;1257;2114
2020-07-21;LE;50-59;867;1314;2181
2020-07-21;SA;50-59;973;1476;2449
2020-07-21;CyL;50-59;5724;8784;14508
2020-07-21;AV;60-69;367;439;806
2020-07-21;BU;60-69;588;720;1308
2020-07-21;LE;60-69;750;939;1689
2020-07-21;ZA;60-69;225;259;484
2020-07-21;AV;70-79;276;298;574
2020-07-21;LE;70-79;632;566;1198
2020-07-21;PA;70-79;195;217;412
2020-07-21;VA;70-79;568;640;1208
2020-07-21;ZA;70-79;159;153;312
2020-07-21;PA;>80;221;423;644
2020-07-21;CyL;>80;4571;8051;12622
2020-07-20;BU;0-9;249;183;432
2020-07-20;SO;10-19;67;61;128
2020-07-20;VA;10-19;320;324;644
2020-07-20;SA;20-29;398;540;938
2020-07-20;VA;20-29;498;702;1200
2020-07-20;ZA;20-29;87;113;200
2020-07-20;CyL;20-29;2493;3330;5823
2020-07-20;BU;30-39;661;882;1543
2020-07-20;SE;30-39;358;532;890
2020-07-20;SO;30-39;190;305;495
2020-07-20;AV;40-49;418;598;1016
2020-07-20;LE;40-49;851;1329;2180
2020-07-20;PA;40-49;363;457;820
2020-07-20;CyL;40-49;5624;8145;13769
2020-07-20;AV;50-59;406;662;1068
2020-07-20;SE;50-59;731;1159;1890
2020-07-20;AV;60-69;367;439;806
2020-07-20;LE;60-69;748;939;1687
2020-07-20;VA;60-69;741;974;1715
2020-07-20;ZA;60-69;225;260;485
2020-07-20;AV;70-79;276;298;574
2020-07-20;SO;70-79;171;163;334
2020-07-20;VA;70-79;563;639;1202
2020-07-20;ZA;70-79;159;153;312
2020-07-20;AV;>80;398;641;1039
2020-07-20;BU;>80;567;988;1555
2020-07-20;VA;>80;660;1338;1998
2020-07-20;AV;0-9;133;118;251
2020-07-20;SA;0-9;288;323;611
2020-07-20;SE;0-9;167;149;316
2020-07-20;SO;0-9;79;61;140
2020-07-20;CyL;0-9;1956;1741;3697
2020-07-20;SA;10-19;222;235;457
2020-07-20;SE;10-19;129;123;252
2020-07-20;ZA;10-19;76;87;163
2020-07-20;CyL;10-19;1466;1437;2903
2020-07-20;BU;20-29;424;529;953
2020-07-20;SE;20-29;235;346;581
2020-07-20;SO;20-29;144;209;353
2020-07-20;AV;30-39;286;398;684
2020-07-20;VA;30-39;783;1162;1945
2020-07-20;BU;40-49;965;1238;2203
2020-07-20;SO;40-49;286;483;769
2020-07-20;VA;40-49;1115;1632;2747
2020-07-20;ZA;40-49;217;331;548
2020-07-20;CyL;50-59;5711;8771;14482
2020-07-20;BU;60-69;587;720;1307
2020-07-20;PA;60-69;295;332;627
2020-07-20;SA;60-69;745;899;1644
2020-07-20;CyL;60-69;4567;5573;10140
2020-07-20;LE;70-79;631;565;1196
2020-07-20;PA;70-79;195;217;412
2020-07-20;SE;70-79;405;407;812
2020-07-20;CyL;70-79;3324;3410;6734
2020-07-20;PA;>80;221;423;644
2020-07-20;ZA;>80;221;345;566
2020-07-20;LE;0-9;264;237;501
2020-07-20;PA;0-9;82;51;133
2020-07-20;VA;0-9;485;423;908
2020-07-20;ZA;0-9;209;196;405
2020-07-20;AV;10-19;128;96;224
2020-07-20;BU;10-19;221;218;439
2020-07-20;LE;10-19;208;212;420
2020-07-20;PA;10-19;95;81;176
2020-07-20;AV;20-29;174;218;392
2020-07-20;LE;20-29;371;484;855
2020-07-20;PA;20-29;162;189;351
2020-07-20;LE;30-39;572;932;1504
2020-07-20;PA;30-39;252;333;585
2020-07-20;SA;30-39;609;917;1526
2020-07-20;ZA;30-39;135;213;348
2020-07-20;CyL;30-39;3846;5674;9520
2020-07-20;SA;40-49;831;1209;2040
2020-07-20;SE;40-49;578;868;1446
2020-07-20;BU;50-59;853;1254;2107
2020-07-20;LE;50-59;862;1312;2174
2020-07-20;PA;50-59;354;490;844
2020-07-20;SA;50-59;970;1476;2446
2020-07-20;SO;50-59;344;574;918
2020-07-20;VA;50-59;949;1466;2415
2020-07-20;ZA;50-59;242;378;620
2020-07-20;SE;60-69;597;675;1272
2020-07-20;SO;60-69;262;335;597
2020-07-20;BU;70-79;414;401;815
2020-07-20;SA;70-79;510;567;1077
2020-07-20;LE;>80;769;1364;2133
2020-07-20;SA;>80;746;1316;2062
2020-07-20;SE;>80;620;989;1609
2020-07-20;SO;>80;368;644;1012
2020-07-20;CyL;>80;4570;8048;12618
2020-07-19;AV;0-9;132;118;250
2020-07-19;BU;0-9;247;187;434
2020-07-19;ZA;0-9;209;194;403
2020-07-19;CyL;0-9;1943;1743;3686
2020-07-19;BU;10-19;219;212;431
2020-07-19;LE;10-19;209;211;420
2020-07-19;PA;10-19;96;81;177
2020-07-19;SA;10-19;220;234;454
2020-07-19;SO;10-19;67;60;127
2020-07-19;CyL;10-19;1458;1424;2882
2020-07-19;AV;20-29;174;218;392
2020-07-19;BU;20-29;418;526;944
2020-07-19;VA;20-29;495;699;1194
2020-07-19;ZA;20-29;87;113;200
2020-07-19;CyL;20-29;2482;3316;5798
2020-07-19;BU;30-39;660;879;1539
2020-07-19;PA;30-39;252;334;586
2020-07-19;SA;30-39;609;916;1525
2020-07-19;SO;30-39;189;304;493
2020-07-19;LE;40-49;850;1328;2178
2020-07-19;PA;40-49;361;458;819
2020-07-19;SE;40-49;577;866;1443
2020-07-19;SO;40-49;286;485;771
2020-07-19;ZA;40-49;215;331;546
2020-07-19;CyL;40-49;5611;8137;13748
2020-07-19;BU;50-59;851;1253;2104
2020-07-19;PA;50-59;355;490;845
2020-07-19;SE;50-59;730;1159;1889
2020-07-19;ZA;50-59;242;379;621
2020-07-19;VA;60-69;741;974;1715
2020-07-19;CyL;60-69;4565;5569;10134
2020-07-19;SA;70-79;510;565;1075
2020-07-19;PA;>80;221;423;644
2020-07-19;SO;>80;367;644;1011
2020-07-19;ZA;>80;221;345;566
2020-07-19;CyL;>80;4567;8047;12614
2020-07-19;LE;0-9;260;237;497
2020-07-19;PA;0-9;83;50;133
2020-07-19;SE;0-9;164;151;315
2020-07-19;VA;0-9;483;425;908
2020-07-19;VA;10-19;316;321;637
2020-07-19;PA;20-29;162;189;351
2020-07-19;SO;20-29;145;205;350
2020-07-19;LE;30-39;571;930;1501
2020-07-19;VA;30-39;782;1162;1944
2020-07-19;ZA;30-39;135;213;348
2020-07-19;CyL;30-39;3844;5666;9510
2020-07-19;AV;40-49;418;596;1014
2020-07-19;LE;50-59;860;1311;2171
2020-07-19;CyL;50-59;5704;8765;14469
2020-07-19;AV;60-69;369;438;807
2020-07-19;PA;60-69;294;332;626
2020-07-19;SO;60-69;261;335;596
2020-07-19;ZA;60-69;225;259;484
2020-07-19;SE;70-79;405;405;810
2020-07-19;SO;70-79;168;163;331
2020-07-19;VA;70-79;563;638;1201
2020-07-19;AV;>80;397;641;1038
2020-07-19;BU;>80;569;986;1555
2020-07-19;LE;>80;766;1363;2129
2020-07-19;SA;>80;745;1316;2061
2020-07-19;VA;>80;659;1339;1998
2020-07-19;SA;0-9;287;321;608
2020-07-19;SO;0-9;78;60;138
2020-07-19;AV;10-19;128;96;224
2020-07-19;SE;10-19;127;121;248
2020-07-19;ZA;10-19;76;88;164
2020-07-19;LE;20-29;369;484;853
2020-07-19;SA;20-29;397;538;935
2020-07-19;SE;20-29;235;344;579
2020-07-19;AV;30-39;286;397;683
2020-07-19;SE;30-39;360;531;891
2020-07-19;BU;40-49;963;1235;2198
2020-07-19;SA;40-49;830;1209;2039
2020-07-19;VA;40-49;1111;1629;2740
2020-07-19;AV;50-59;406;661;1067
2020-07-19;SA;50-59;970;1475;2445
2020-07-19;SO;50-59;343;574;917
2020-07-19;VA;50-59;947;1463;2410
2020-07-19;BU;60-69;587;719;1306
2020-07-19;LE;60-69;748;937;1685
2020-07-19;SA;60-69;744;900;1644
2020-07-19;SE;60-69;596;675;1271
2020-07-19;AV;70-79;276;295;571
2020-07-19;BU;70-79;414;400;814
2020-07-19;LE;70-79;631;565;1196
2020-07-19;PA;70-79;196;219;415
2020-07-19;ZA;70-79;160;153;313
2020-07-19;CyL;70-79;3323;3403;6726
2020-07-19;SE;>80;622;990;1612
2020-07-16;VA;0-9;481;423;904
2020-07-16;ZA;0-9;207;194;401
2020-07-16;SE;10-19;126;119;245
2020-07-16;SO;10-19;65;58;123
2020-07-16;VA;10-19;318;321;639
2020-07-16;BU;20-29;409;526;935
2020-07-16;PA;20-29;161;187;348
2020-07-16;SE;20-29;236;343;579
2020-07-16;SO;20-29;144;205;349
2020-07-16;AV;30-39;283;397;680
2020-07-16;LE;30-39;567;925;1492
2020-07-16;PA;30-39;252;331;583
2020-07-16;SA;30-39;610;915;1525
2020-07-16;VA;30-39;779;1158;1937
2020-07-16;ZA;30-39;134;213;347
2020-07-16;AV;40-49;418;595;1013
2020-07-16;SA;40-49;830;1208;2038
2020-07-16;SE;40-49;576;863;1439
2020-07-16;LE;50-59;859;1307;2166
2020-07-16;SE;50-59;729;1158;1887
2020-07-16;SO;50-59;342;570;912
2020-07-16;VA;50-59;942;1460;2402
2020-07-16;BU;60-69;584;719;1303
2020-07-16;LE;60-69;747;934;1681
2020-07-16;SA;60-69;743;899;1642
2020-07-16;VA;60-69;736;973;1709
2020-07-16;CyL;60-69;4553;5559;10112
2020-07-16;BU;70-79;412;396;808
2020-07-16;PA;70-79;195;218;413
2020-07-16;VA;70-79;564;637;1201
2020-07-16;CyL;70-79;3315;3391;6706
2020-07-16;AV;>80;396;640;1036
2020-07-16;BU;>80;564;984;1548
2020-07-16;LE;>80;763;1360;2123
2020-07-16;SO;>80;367;644;1011
2020-07-16;VA;>80;657;1337;1994
2020-07-16;AV;0-9;132;117;249
2020-07-16;LE;0-9;260;237;497
2020-07-16;SA;0-9;286;318;604
2020-07-16;SE;0-9;162;148;310
2020-07-16;LE;20-29;366;484;850
2020-07-16;VA;20-29;492;695;1187
2020-07-16;ZA;20-29;87;113;200
2020-07-16;CyL;20-29;2463;3310;5773
2020-07-16;CyL;30-39;3825;5647;9472
2020-07-16;BU;40-49;960;1234;2194
2020-07-16;LE;40-49;847;1325;2172
2020-07-16;SO;40-49;283;480;763
2020-07-16;VA;40-49;1107;1624;2731
2020-07-16;AV;50-59;405;660;1065
2020-07-16;PA;50-59;356;490;846
2020-07-16;AV;60-69;369;436;805
2020-07-16;PA;60-69;294;332;626
2020-07-16;SE;60-69;597;674;1271
2020-07-16;AV;70-79;275;295;570
2020-07-16;LE;70-79;629;565;1194
2020-07-16;SA;70-79;509;564;1073
2020-07-16;SE;70-79;403;402;805
2020-07-16;SE;>80;615;981;1596
2020-07-16;ZA;>80;221;346;567
2020-07-16;CyL;>80;4549;8032;12581
2020-07-16;BU;0-9;248;181;429
2020-07-16;PA;0-9;84;49;133
2020-07-16;SO;0-9;79;60;139
2020-07-16;CyL;0-9;1939;1727;3666
2020-07-16;AV;10-19;125;96;221
2020-07-16;BU;10-19;217;206;423
2020-07-16;LE;10-19;204;210;414
2020-07-16;PA;10-19;95;79;174
2020-07-16;SA;10-19;217;233;450
2020-07-16;ZA;10-19;76;86;162
2020-07-16;CyL;10-19;1443;1408;2851
2020-07-16;AV;20-29;173;218;391
2020-07-16;SA;20-29;395;539;934
2020-07-16;BU;30-39;652;872;1524
2020-07-16;SE;30-39;359;532;891
2020-07-16;SO;30-39;189;304;493
2020-07-16;PA;40-49;364;457;821
2020-07-16;ZA;40-49;215;330;545
2020-07-16;CyL;40-49;5600;8116;13716
2020-07-16;BU;50-59;849;1249;2098
2020-07-16;SA;50-59;970;1475;2445
2020-07-16;ZA;50-59;242;379;621
2020-07-16;CyL;50-59;5694;8748;14442
2020-07-16;SO;60-69;259;334;593
2020-07-16;ZA;60-69;224;258;482
2020-07-16;SO;70-79;168;161;329
2020-07-16;ZA;70-79;160;153;313
2020-07-16;PA;>80;221;424;645
2020-07-16;SA;>80;745;1316;2061
2020-07-15;SO;0-9;79;60;139
2020-07-15;CyL;0-9;1943;1725;3668
2020-07-15;SA;10-19;217;233;450
2020-07-15;ZA;10-19;76;85;161
2020-07-15;CyL;10-19;1440;1405;2845
2020-07-15;AV;20-29;172;218;390
2020-07-15;LE;20-29;365;482;847
2020-07-15;SE;20-29;234;342;576
2020-07-15;SA;30-39;608;914;1522
2020-07-15;SO;30-39;188;305;493
2020-07-15;VA;30-39;779;1156;1935
2020-07-15;ZA;30-39;134;214;348
2020-07-15;SA;40-49;831;1208;2039
2020-07-15;ZA;40-49;215;330;545
2020-07-15;SE;50-59;725;1158;1883
2020-07-15;SO;50-59;340;569;909
2020-07-15;VA;50-59;940;1456;2396
2020-07-15;AV;60-69;370;436;806
2020-07-15;SE;60-69;597;674;1271
2020-07-15;ZA;60-69;224;258;482
2020-07-15;CyL;60-69;4548;5553;10101
2020-07-15;AV;70-79;275;295;570
2020-07-15;LE;70-79;629;563;1192
2020-07-15;PA;70-79;195;218;413
2020-07-15;VA;70-79;564;637;1201
2020-07-15;BU;>80;565;983;1548
2020-07-15;AV;0-9;132;117;249
2020-07-15;PA;0-9;84;49;133
2020-07-15;SA;0-9;286;318;604
2020-07-15;SE;0-9;164;147;311
2020-07-15;ZA;0-9;207;194;401
2020-07-15;LE;10-19;204;210;414
2020-07-15;PA;10-19;95;78;173
2020-07-15;SO;10-19;64;58;122
2020-07-15;BU;20-29;410;525;935
2020-07-15;VA;20-29;491;692;1183
2020-07-15;ZA;20-29;86;113;199
2020-07-15;CyL;20-29;2456;3301;5757
2020-07-15;AV;30-39;283;397;680
2020-07-15;BU;30-39;653;869;1522
2020-07-15;LE;30-39;566;923;1489
2020-07-15;PA;30-39;252;329;581
2020-07-15;CyL;30-39;3820;5637;9457
2020-07-15;SO;40-49;284;479;763
2020-07-15;VA;40-49;1107;1622;2729
2020-07-15;CyL;40-49;5602;8106;13708
2020-07-15;AV;50-59;405;660;1065
2020-07-15;BU;50-59;851;1249;2100
2020-07-15;PA;50-59;355;489;844
2020-07-15;ZA;50-59;242;380;622
2020-07-15;PA;60-69;291;333;624
2020-07-15;VA;60-69;733;972;1705
2020-07-15;SA;70-79;506;563;1069
2020-07-15;SE;70-79;403;398;801
2020-07-15;SO;70-79;168;161;329
2020-07-15;VA;>80;658;1337;1995
2020-07-15;BU;0-9;252;183;435
2020-07-15;LE;0-9;261;235;496
2020-07-15;VA;0-9;478;422;900
2020-07-15;AV;10-19;125;95;220
2020-07-15;BU;10-19;218;206;424
2020-07-15;SE;10-19;124;119;243
2020-07-15;VA;10-19;317;321;638
2020-07-15;PA;20-29;160;187;347
2020-07-15;SA;20-29;394;539;933
2020-07-15;SO;20-29;144;203;347
2020-07-15;SE;30-39;357;530;887
2020-07-15;AV;40-49;418;595;1013
2020-07-15;BU;40-49;961;1234;2195
2020-07-15;LE;40-49;847;1321;2168
2020-07-15;PA;40-49;363;457;820
2020-07-15;SE;40-49;576;860;1436
2020-07-15;LE;50-59;858;1307;2165
2020-07-15;SA;50-59;970;1475;2445
2020-07-15;CyL;50-59;5686;8743;14429
2020-07-15;BU;60-69;586;718;1304
2020-07-15;LE;60-69;745;934;1679
2020-07-15;SA;60-69;743;895;1638
2020-07-15;SO;60-69;259;333;592
2020-07-15;BU;70-79;414;395;809
2020-07-15;ZA;70-79;160;154;314
2020-07-15;CyL;70-79;3314;3384;6698
2020-07-15;AV;>80;395;641;1036
2020-07-15;LE;>80;763;1360;2123
2020-07-15;PA;>80;221;421;642
2020-07-15;SA;>80;744;1313;2057
2020-07-15;SE;>80;614;975;1589
2020-07-15;SO;>80;365;644;1009
2020-07-15;ZA;>80;221;346;567
2020-07-15;CyL;>80;4546;8020;12566
2020-07-14;AV;0-9;132;118;250
2020-07-14;BU;0-9;250;177;427
2020-07-14;SO;0-9;78;60;138
2020-07-14;CyL;0-9;1940;1721;3661
2020-07-14;ZA;10-19;76;85;161
2020-07-14;AV;20-29;172;217;389
2020-07-14;LE;20-29;364;482;846
2020-07-14;SE;20-29;233;342;575
2020-07-14;VA;20-29;492;689;1181
2020-07-14;AV;30-39;283;397;680
2020-07-14;SA;30-39;608;914;1522
2020-07-14;SE;30-39;354;529;883
2020-07-14;BU;40-49;960;1235;2195
2020-07-14;SA;40-49;832;1207;2039
2020-07-14;PA;50-59;355;488;843
2020-07-14;LE;60-69;744;932;1676
2020-07-14;PA;60-69;291;332;623
2020-07-14;SA;60-69;741;894;1635
2020-07-14;ZA;60-69;224;258;482
2020-07-14;SA;70-79;506;563;1069
2020-07-14;SE;70-79;404;396;800
2020-07-14;LE;>80;762;1360;2122
2020-07-14;SA;>80;744;1313;2057
2020-07-14;LE;0-9;260;235;495
2020-07-14;PA;0-9;84;50;134
2020-07-14;SE;0-9;165;146;311
2020-07-14;ZA;0-9;206;194;400
2020-07-14;LE;10-19;200;209;409
2020-07-14;SA;10-19;217;233;450
2020-07-14;SE;10-19;121;120;241
2020-07-14;VA;10-19;314;318;632
2020-07-14;CyL;10-19;1429;1404;2833
2020-07-14;SO;20-29;142;200;342
2020-07-14;ZA;20-29;86;114;200
2020-07-14;LE;30-39;563;922;1485
2020-07-14;SO;30-39;187;304;491
2020-07-14;VA;30-39;778;1154;1932
2020-07-14;LE;40-49;847;1321;2168
2020-07-14;PA;40-49;361;454;815
2020-07-14;VA;40-49;1109;1620;2729
2020-07-14;BU;50-59;849;1250;2099
2020-07-14;SA;50-59;968;1475;2443
2020-07-14;SE;50-59;727;1156;1883
2020-07-14;SO;50-59;341;570;911
2020-07-14;VA;50-59;937;1456;2393
2020-07-14;ZA;50-59;242;381;623
2020-07-14;SE;60-69;595;672;1267
2020-07-14;VA;60-69;728;971;1699
2020-07-14;BU;70-79;416;397;813
2020-07-14;PA;70-79;195;217;412
2020-07-14;ZA;70-79;159;154;313
2020-07-14;AV;>80;395;640;1035
2020-07-14;BU;>80;562;983;1545
2020-07-14;SO;>80;365;644;1009
2020-07-14;ZA;>80;222;345;567
2020-07-14;SA;0-9;285;318;603
2020-07-14;VA;0-9;480;423;903
2020-07-14;AV;10-19;127;94;221
2020-07-14;BU;10-19;217;211;428
2020-07-14;PA;10-19;94;76;170
2020-07-14;SO;10-19;63;58;121
2020-07-14;BU;20-29;408;526;934
2020-07-14;PA;20-29;158;188;346
2020-07-14;SA;20-29;393;539;932
2020-07-14;CyL;20-29;2448;3297;5745
2020-07-14;BU;30-39;654;867;1521
2020-07-14;PA;30-39;250;329;579
2020-07-14;ZA;30-39;134;214;348
2020-07-14;CyL;30-39;3811;5630;9441
2020-07-14;AV;40-49;418;594;1012
2020-07-14;SE;40-49;574;860;1434
2020-07-14;SO;40-49;283;478;761
2020-07-14;ZA;40-49;215;330;545
2020-07-14;CyL;40-49;5599;8099;13698
2020-07-14;AV;50-59;406;660;1066
2020-07-14;LE;50-59;860;1305;2165
2020-07-14;CyL;50-59;5685;8741;14426
2020-07-14;AV;60-69;370;436;806
2020-07-14;BU;60-69;584;717;1301
2020-07-14;SO;60-69;259;332;591
2020-07-14;CyL;60-69;4536;5544;10080
2020-07-14;AV;70-79;275;295;570
2020-07-14;LE;70-79;628;563;1191
2020-07-14;SO;70-79;168;161;329
2020-07-14;VA;70-79;564;637;1201
2020-07-14;CyL;70-79;3315;3383;6698
2020-07-14;PA;>80;220;420;640
2020-07-14;SE;>80;615;975;1590
2020-07-14;VA;>80;657;1337;1994
2020-07-14;CyL;>80;4542;8017;12559
2020-07-13;LE;0-9;258;232;490
2020-07-13;PA;0-9;82;50;132
2020-07-13;VA;0-9;479;422;901
2020-07-13;ZA;0-9;206;194;400
2020-07-13;ZA;10-19;75;84;159
2020-07-13;PA;20-29;158;185;343
2020-07-13;SA;20-29;393;536;929
2020-07-13;VA;20-29;488;686;1174
2020-07-13;ZA;20-29;86;114;200
2020-07-13;CyL;20-29;2441;3284;5725
2020-07-13;AV;30-39;283;397;680
2020-07-13;SA;30-39;608;913;1521
2020-07-13;VA;30-39;776;1154;1930
2020-07-13;AV;40-49;418;594;1012
2020-07-13;SA;40-49;829;1206;2035
2020-07-13;BU;50-59;847;1246;2093
2020-07-13;LE;50-59;860;1305;2165
2020-07-13;PA;50-59;353;486;839
2020-07-13;SA;50-59;965;1474;2439
2020-07-13;SO;50-59;340;569;909
2020-07-13;SA;60-69;741;893;1634
2020-07-13;CyL;60-69;4534;5536;10070
2020-07-13;LE;70-79;627;562;1189
2020-07-13;SA;70-79;506;563;1069
2020-07-13;SE;70-79;403;394;797
2020-07-13;CyL;70-79;3307;3379;6686
2020-07-13;SA;>80;743;1310;2053
2020-07-13;CyL;>80;4535;8011;12546
2020-07-13;AV;0-9;132;116;248
2020-07-13;SA;0-9;285;318;603
2020-07-13;SO;0-9;78;60;138
2020-07-13;BU;10-19;216;210;426
2020-07-13;PA;10-19;94;75;169
2020-07-13;SE;10-19;121;119;240
2020-07-13;VA;10-19;312;315;627
2020-07-13;BU;20-29;405;525;930
2020-07-13;LE;20-29;363;480;843
2020-07-13;SE;20-29;233;340;573
2020-07-13;BU;30-39;652;863;1515
2020-07-13;PA;30-39;249;329;578
2020-07-13;SO;30-39;186;304;490
2020-07-13;ZA;30-39;132;214;346
2020-07-13;BU;40-49;960;1233;2193
2020-07-13;PA;40-49;361;453;814
2020-07-13;SO;40-49;284;478;762
2020-07-13;VA;40-49;1109;1616;2725
2020-07-13;CyL;40-49;5596;8089;13685
2020-07-13;VA;50-59;937;1457;2394
2020-07-13;ZA;50-59;242;381;623
2020-07-13;BU;60-69;583;714;1297
2020-07-13;LE;60-69;744;932;1676
2020-07-13;SE;60-69;595;672;1267
2020-07-13;SO;60-69;259;331;590
2020-07-13;ZA;60-69;224;258;482
2020-07-13;BU;70-79;413;397;810
2020-07-13;VA;70-79;563;637;1200
2020-07-13;AV;>80;393;639;1032
2020-07-13;LE;>80;762;1359;2121
2020-07-13;VA;>80;655;1340;1995
2020-07-13;BU;0-9;246;178;424
2020-07-13;SE;0-9;163;145;308
2020-07-13;CyL;0-9;1929;1715;3644
2020-07-13;AV;10-19;127;94;221
2020-07-13;LE;10-19;201;207;408
2020-07-13;SA;10-19;217;232;449
2020-07-13;SO;10-19;64;57;121
2020-07-13;CyL;10-19;1427;1393;2820
2020-07-13;AV;20-29;172;218;390
2020-07-13;SO;20-29;143;200;343
2020-07-13;LE;30-39;561;921;1482
2020-07-13;SE;30-39;352;529;881
2020-07-13;CyL;30-39;3799;5624;9423
2020-07-13;LE;40-49;847;1320;2167
2020-07-13;SE;40-49;573;859;1432
2020-07-13;ZA;40-49;215;330;545
2020-07-13;AV;50-59;406;660;1066
2020-07-13;SE;50-59;725;1157;1882
2020-07-13;CyL;50-59;5675;8735;14410
2020-07-13;AV;60-69;370;436;806
2020-07-13;PA;60-69;290;329;619
2020-07-13;VA;60-69;728;971;1699
2020-07-13;AV;70-79;274;294;568
2020-07-13;PA;70-79;195;217;412
2020-07-13;SO;70-79;167;161;328
2020-07-13;ZA;70-79;159;154;313
2020-07-13;BU;>80;562;984;1546
2020-07-13;PA;>80;220;418;638
2020-07-13;SE;>80;613;973;1586
2020-07-13;SO;>80;365;645;1010
2020-07-13;ZA;>80;222;343;565
2020-07-12;AV;0-9;133;115;248
2020-07-12;VA;0-9;477;415;892
2020-07-12;ZA;0-9;206;194;400
2020-07-12;CyL;0-9;1923;1706;3629
2020-07-12;AV;10-19;125;94;219
2020-07-12;BU;10-19;213;207;420
2020-07-12;SE;10-19;122;117;239
2020-07-12;ZA;10-19;75;84;159
2020-07-12;CyL;10-19;1422;1385;2807
2020-07-12;AV;20-29;172;217;389
2020-07-12;BU;20-29;402;524;926
2020-07-12;PA;20-29;159;185;344
2020-07-12;SA;20-29;392;535;927
2020-07-12;CyL;20-29;2435;3274;5709
2020-07-12;BU;30-39;652;859;1511
2020-07-12;LE;40-49;845;1319;2164
2020-07-12;CyL;40-49;5588;8079;13667
2020-07-12;SA;50-59;961;1472;2433
2020-07-12;SE;50-59;724;1154;1878
2020-07-12;ZA;50-59;241;380;621
2020-07-12;AV;60-69;370;436;806
2020-07-12;LE;60-69;745;929;1674
2020-07-12;PA;60-69;290;329;619
2020-07-12;SO;60-69;258;330;588
2020-07-12;AV;70-79;274;292;566
2020-07-12;PA;70-79;196;217;413
2020-07-12;VA;70-79;561;633;1194
2020-07-12;BU;0-9;242;180;422
2020-07-12;SA;0-9;283;316;599
2020-07-12;LE;10-19;201;207;408
2020-07-12;PA;10-19;94;75;169
2020-07-12;SA;10-19;216;231;447
2020-07-12;SE;20-29;233;338;571
2020-07-12;VA;20-29;487;685;1172
2020-07-12;LE;30-39;559;918;1477
2020-07-12;SE;30-39;352;529;881
2020-07-12;ZA;30-39;131;214;345
2020-07-12;AV;40-49;417;593;1010
2020-07-12;BU;40-49;958;1230;2188
2020-07-12;SA;40-49;827;1205;2032
2020-07-12;SE;40-49;574;857;1431
2020-07-12;VA;40-49;1108;1616;2724
2020-07-12;ZA;40-49;216;330;546
2020-07-12;LE;50-59;858;1303;2161
2020-07-12;VA;50-59;935;1455;2390
2020-07-12;CyL;50-59;5664;8726;14390
2020-07-12;BU;60-69;581;711;1292
2020-07-12;SE;60-69;595;668;1263
2020-07-12;VA;60-69;728;971;1699
2020-07-12;CyL;60-69;4531;5524;10055
2020-07-12;BU;70-79;410;393;803
2020-07-12;LE;70-79;624;561;1185
2020-07-12;SA;70-79;505;563;1068
2020-07-12;SE;70-79;403;394;797
2020-07-12;LE;>80;761;1359;2120
2020-07-12;PA;>80;220;415;635
2020-07-12;SA;>80;742;1310;2052
2020-07-12;LE;0-9;258;231;489
2020-07-12;PA;0-9;84;49;133
2020-07-12;SE;0-9;161;146;307
2020-07-12;SO;0-9;79;60;139
2020-07-12;SO;10-19;64;55;119
2020-07-12;VA;10-19;312;315;627
2020-07-12;LE;20-29;361;479;840
2020-07-12;SO;20-29;143;198;341
2020-07-12;ZA;20-29;86;113;199
2020-07-12;AV;30-39;283;398;681
2020-07-12;PA;30-39;250;330;580
2020-07-12;SA;30-39;607;912;1519
2020-07-12;SO;30-39;185;303;488
2020-07-12;VA;30-39;774;1151;1925
2020-07-12;CyL;30-39;3793;5614;9407
2020-07-12;PA;40-49;361;451;812
2020-07-12;SO;40-49;282;478;760
2020-07-12;AV;50-59;405;660;1065
2020-07-12;BU;50-59;847;1245;2092
2020-07-12;PA;50-59;353;488;841
2020-07-12;SO;50-59;340;569;909
2020-07-12;SA;60-69;741;892;1633
2020-07-12;ZA;60-69;223;258;481
2020-07-12;SO;70-79;168;161;329
2020-07-12;ZA;70-79;158;154;312
2020-07-12;CyL;70-79;3299;3368;6667
2020-07-12;AV;>80;393;638;1031
2020-07-12;BU;>80;563;983;1546
2020-07-12;SE;>80;613;970;1583
2020-07-12;SO;>80;365;642;1007
2020-07-12;VA;>80;655;1340;1995
2020-07-12;ZA;>80;222;343;565
2020-07-12;CyL;>80;4534;8000;12534
2020-07-09;AV;0-9;130;114;244
2020-07-09;SA;0-9;283;315;598
2020-07-09;SE;0-9;157;142;299
2020-07-09;VA;0-9;471;408;879
2020-07-09;ZA;0-9;205;192;397
2020-07-09;AV;10-19;123;92;215
2020-07-09;BU;10-19;214;204;418
2020-07-09;SA;10-19;215;231;446
2020-07-09;SE;10-19;123;115;238
2020-07-09;ZA;10-19;75;83;158
2020-07-09;CyL;10-19;1414;1372;2786
2020-07-09;ZA;20-29;86;112;198
2020-07-09;BU;30-39;656;860;1516
2020-07-09;LE;30-39;558;918;1476
2020-07-09;SA;30-39;607;911;1518
2020-07-09;SE;30-39;349;527;876
2020-07-09;VA;30-39;771;1149;1920
2020-07-09;BU;40-49;955;1232;2187
2020-07-09;SA;40-49;826;1203;2029
2020-07-09;VA;40-49;1101;1613;2714
2020-07-09;ZA;40-49;216;330;546
2020-07-09;CyL;40-49;5573;8072;13645
2020-07-09;LE;60-69;744;926;1670
2020-07-09;PA;60-69;288;329;617
2020-07-09;ZA;60-69;223;258;481
2020-07-09;AV;70-79;272;291;563
2020-07-09;BU;70-79;411;390;801
2020-07-09;SO;70-79;167;161;328
2020-07-09;VA;70-79;559;632;1191
2020-07-09;AV;>80;393;636;1029
2020-07-09;VA;>80;654;1338;1992
2020-07-09;CyL;>80;4527;7986;12513
2020-07-09;LE;0-9;259;231;490
2020-07-09;PA;0-9;82;49;131
2020-07-09;SO;0-9;79;59;138
2020-07-09;CyL;0-9;1908;1690;3598
2020-07-09;LE;10-19;197;205;402
2020-07-09;PA;10-19;93;74;167
2020-07-09;AV;20-29;173;217;390
2020-07-09;BU;20-29;399;524;923
2020-07-09;SO;20-29;140;196;336
2020-07-09;VA;20-29;482;684;1166
2020-07-09;SO;30-39;187;303;490
2020-07-09;ZA;30-39;130;213;343
2020-07-09;PA;40-49;361;451;812
2020-07-09;SE;40-49;573;856;1429
2020-07-09;AV;50-59;406;658;1064
2020-07-09;LE;50-59;853;1301;2154
2020-07-09;SA;50-59;958;1472;2430
2020-07-09;SE;50-59;722;1151;1873
2020-07-09;AV;60-69;369;435;804
2020-07-09;BU;60-69;582;709;1291
2020-07-09;SA;60-69;742;891;1633
2020-07-09;SE;60-69;596;668;1264
2020-07-09;LE;70-79;622;561;1183
2020-07-09;PA;70-79;193;216;409
2020-07-09;SA;70-79;504;562;1066
2020-07-09;CyL;70-79;3287;3359;6646
2020-07-09;BU;>80;562;978;1540
2020-07-09;LE;>80;760;1356;2116
2020-07-09;PA;>80;220;414;634
2020-07-09;SE;>80;610;969;1579
2020-07-09;SO;>80;364;643;1007
2020-07-09;ZA;>80;222;342;564
2020-07-09;BU;0-9;242;180;422
2020-07-09;SO;10-19;64;54;118
2020-07-09;VA;10-19;310;314;624
2020-07-09;LE;20-29;361;477;838
2020-07-09;PA;20-29;157;185;342
2020-07-09;SA;20-29;390;535;925
2020-07-09;SE;20-29;231;339;570
2020-07-09;CyL;20-29;2419;3269;5688
2020-07-09;AV;30-39;281;393;674
2020-07-09;PA;30-39;251;331;582
2020-07-09;CyL;30-39;3790;5605;9395
2020-07-09;AV;40-49;419;592;1011
2020-07-09;LE;40-49;841;1318;2159
2020-07-09;SO;40-49;281;477;758
2020-07-09;BU;50-59;849;1242;2091
2020-07-09;PA;50-59;353;487;840
2020-07-09;SO;50-59;340;568;908
2020-07-09;VA;50-59;932;1452;2384
2020-07-09;ZA;50-59;241;379;620
2020-07-09;CyL;50-59;5654;8710;14364
2020-07-09;SO;60-69;258;330;588
2020-07-09;VA;60-69;727;968;1695
2020-07-09;CyL;60-69;4529;5514;10043
2020-07-09;SE;70-79;401;392;793
2020-07-09;ZA;70-79;158;154;312
2020-07-09;SA;>80;742;1310;2052
2020-07-08;LE;0-9;257;232;489
2020-07-08;PA;0-9;83;48;131
2020-07-08;SE;0-9;159;144;303
2020-07-08;ZA;0-9;204;192;396
2020-07-08;CyL;0-9;1909;1688;3597
2020-07-08;AV;10-19;122;92;214
2020-07-08;SO;10-19;63;53;116
2020-07-08;VA;10-19;312;315;627
2020-07-08;AV;20-29;173;217;390
2020-07-08;SA;20-29;390;534;924
2020-07-08;VA;20-29;480;685;1165
2020-07-08;ZA;30-39;129;213;342
2020-07-08;LE;40-49;840;1314;2154
2020-07-08;PA;40-49;359;449;808
2020-07-08;SA;40-49;826;1202;2028
2020-07-08;SO;40-49;281;477;758
2020-07-08;AV;50-59;406;657;1063
2020-07-08;BU;50-59;847;1240;2087
2020-07-08;PA;50-59;352;487;839
2020-07-08;SA;50-59;957;1472;2429
2020-07-08;SE;50-59;722;1149;1871
2020-07-08;SO;50-59;340;567;907
2020-07-08;VA;50-59;931;1450;2381
2020-07-08;ZA;50-59;240;379;619
2020-07-08;LE;60-69;742;926;1668
2020-07-08;CyL;60-69;4524;5505;10029
2020-07-08;LE;70-79;621;561;1182
2020-07-08;PA;70-79;193;216;409
2020-07-08;SO;70-79;167;160;327
2020-07-08;VA;70-79;559;632;1191
2020-07-08;CyL;70-79;3283;3353;6636
2020-07-08;LE;>80;759;1355;2114
2020-07-08;VA;>80;654;1339;1993
2020-07-08;SA;0-9;283;315;598
2020-07-08;SO;0-9;78;59;137
2020-07-08;LE;10-19;197;204;401
2020-07-08;PA;10-19;92;74;166
2020-07-08;ZA;10-19;75;83;158
2020-07-08;LE;20-29;359;476;835
2020-07-08;PA;20-29;156;185;341
2020-07-08;SE;30-39;349;526;875
2020-07-08;AV;40-49;419;590;1009
2020-07-08;BU;40-49;955;1231;2186
2020-07-08;CyL;40-49;5565;8056;13621
2020-07-08;LE;50-59;851;1300;2151
2020-07-08;AV;60-69;369;433;802
2020-07-08;PA;60-69;289;328;617
2020-07-08;SA;60-69;741;889;1630
2020-07-08;SE;60-69;592;666;1258
2020-07-08;VA;60-69;728;968;1696
2020-07-08;AV;70-79;272;291;563
2020-07-08;SE;70-79;400;390;790
2020-07-08;AV;>80;393;635;1028
2020-07-08;SO;>80;364;642;1006
2020-07-08;ZA;>80;223;342;565
2020-07-08;AV;0-9;130;115;245
2020-07-08;BU;0-9;240;176;416
2020-07-08;VA;0-9;475;407;882
2020-07-08;BU;10-19;213;204;417
2020-07-08;SA;10-19;214;231;445
2020-07-08;SE;10-19;121;113;234
2020-07-08;CyL;10-19;1409;1369;2778
2020-07-08;BU;20-29;397;525;922
2020-07-08;SE;20-29;229;336;565
2020-07-08;SO;20-29;140;195;335
2020-07-08;ZA;20-29;86;112;198
2020-07-08;CyL;20-29;2410;3265;5675
2020-07-08;AV;30-39;281;391;672
2020-07-08;BU;30-39;655;860;1515
2020-07-08;LE;30-39;558;917;1475
2020-07-08;PA;30-39;252;330;582
2020-07-08;SA;30-39;605;909;1514
2020-07-08;SO;30-39;187;302;489
2020-07-08;VA;30-39;770;1147;1917
2020-07-08;CyL;30-39;3786;5595;9381
2020-07-08;SE;40-49;571;853;1424
2020-07-08;VA;40-49;1098;1610;2708
2020-07-08;ZA;40-49;216;330;546
2020-07-08;CyL;50-59;5646;8701;14347
2020-07-08;BU;60-69;582;709;1291
2020-07-08;SO;60-69;258;328;586
2020-07-08;ZA;60-69;223;258;481
2020-07-08;BU;70-79;410;387;797
2020-07-08;SA;70-79;504;562;1066
2020-07-08;ZA;70-79;157;154;311
2020-07-08;BU;>80;563;979;1542
2020-07-08;PA;>80;219;413;632
2020-07-08;SA;>80;741;1310;2051
2020-07-08;SE;>80;610;965;1575
2020-07-08;CyL;>80;4526;7980;12506
2020-07-07;SA;0-9;283;314;597
2020-07-07;SE;0-9;156;143;299
2020-07-07;SO;0-9;77;59;136
2020-07-07;CyL;0-9;1897;1682;3579
2020-07-07;BU;10-19;210;204;414
2020-07-07;PA;10-19;93;75;168
2020-07-07;SA;10-19;214;230;444
2020-07-07;SE;10-19;119;111;230
2020-07-07;SO;10-19;62;52;114
2020-07-07;VA;10-19;310;313;623
2020-07-07;SE;20-29;230;334;564
2020-07-07;SO;20-29;138;194;332
2020-07-07;VA;20-29;476;684;1160
2020-07-07;ZA;20-29;86;112;198
2020-07-07;CyL;20-29;2400;3257;5657
2020-07-07;AV;30-39;281;391;672
2020-07-07;LE;30-39;558;915;1473
2020-07-07;PA;30-39;251;329;580
2020-07-07;CyL;30-39;3780;5589;9369
2020-07-07;PA;40-49;361;446;807
2020-07-07;SA;40-49;826;1201;2027
2020-07-07;VA;40-49;1098;1611;2709
2020-07-07;AV;50-59;404;658;1062
2020-07-07;PA;50-59;352;485;837
2020-07-07;SA;50-59;957;1470;2427
2020-07-07;SO;50-59;340;566;906
2020-07-07;CyL;50-59;5641;8686;14327
2020-07-07;BU;60-69;581;708;1289
2020-07-07;PA;60-69;289;328;617
2020-07-07;SO;60-69;256;327;583
2020-07-07;BU;70-79;408;389;797
2020-07-07;SA;70-79;504;562;1066
2020-07-07;VA;70-79;557;630;1187
2020-07-07;CyL;70-79;3273;3349;6622
2020-07-07;BU;>80;562;979;1541
2020-07-07;LE;>80;760;1355;2115
2020-07-07;AV;0-9;130;115;245
2020-07-07;BU;0-9;237;175;412
2020-07-07;LE;0-9;256;232;488
2020-07-07;ZA;0-9;204;191;395
2020-07-07;AV;10-19;121;92;213
2020-07-07;LE;10-19;197;204;401
2020-07-07;ZA;10-19;76;83;159
2020-07-07;SA;20-29;389;533;922
2020-07-07;SA;30-39;605;908;1513
2020-07-07;SO;30-39;185;302;487
2020-07-07;VA;30-39;773;1145;1918
2020-07-07;AV;40-49;417;589;1006
2020-07-07;BU;40-49;955;1229;2184
2020-07-07;SE;40-49;570;855;1425
2020-07-07;BU;50-59;847;1239;2086
2020-07-07;AV;60-69;368;433;801
2020-07-07;LE;60-69;741;926;1667
2020-07-07;SA;60-69;742;886;1628
2020-07-07;SE;60-69;591;666;1257
2020-07-07;ZA;60-69;222;258;480
2020-07-07;AV;70-79;270;291;561
2020-07-07;SA;>80;742;1310;2052
2020-07-07;SE;>80;608;964;1572
2020-07-07;PA;0-9;81;47;128
2020-07-07;VA;0-9;473;406;879
2020-07-07;CyL;10-19;1402;1364;2766
2020-07-07;AV;20-29;171;217;388
2020-07-07;BU;20-29;395;524;919
2020-07-07;LE;20-29;358;475;833
2020-07-07;PA;20-29;157;184;341
2020-07-07;BU;30-39;650;859;1509
2020-07-07;SE;30-39;348;526;874
2020-07-07;ZA;30-39;129;214;343
2020-07-07;LE;40-49;840;1313;2153
2020-07-07;SO;40-49;281;475;756
2020-07-07;ZA;40-49;216;330;546
2020-07-07;CyL;40-49;5564;8049;13613
2020-07-07;LE;50-59;849;1294;2143
2020-07-07;SE;50-59;722;1148;1870
2020-07-07;VA;50-59;930;1447;2377
2020-07-07;ZA;50-59;240;379;619
2020-07-07;VA;60-69;726;964;1690
2020-07-07;CyL;60-69;4516;5496;10012
2020-07-07;LE;70-79;618;560;1178
2020-07-07;PA;70-79;193;216;409
2020-07-07;SE;70-79;400;389;789
2020-07-07;SO;70-79;166;158;324
2020-07-07;ZA;70-79;157;154;311
2020-07-07;AV;>80;393;634;1027
2020-07-07;PA;>80;219;413;632
2020-07-07;SO;>80;362;642;1004
2020-07-07;VA;>80;654;1336;1990
2020-07-07;ZA;>80;222;342;564
2020-07-07;CyL;>80;4522;7975;12497
2020-07-06;SO;0-9;77;59;136
2020-07-06;CyL;0-9;1890;1678;3568
2020-07-06;SA;10-19;213;229;442
2020-07-06;SO;10-19;61;52;113
2020-07-06;AV;20-29;171;217;388
2020-07-06;BU;20-29;395;523;918
2020-07-06;LE;20-29;357;473;830
2020-07-06;PA;20-29;159;184;343
2020-07-06;SE;20-29;228;333;561
2020-07-06;VA;20-29;474;683;1157
2020-07-06;CyL;20-29;2397;3253;5650
2020-07-06;AV;30-39;281;391;672
2020-07-06;BU;30-39;647;860;1507
2020-07-06;SE;30-39;348;524;872
2020-07-06;VA;30-39;770;1143;1913
2020-07-06;BU;40-49;953;1229;2182
2020-07-06;LE;40-49;838;1311;2149
2020-07-06;SO;40-49;279;474;753
2020-07-06;VA;40-49;1100;1611;2711
2020-07-06;BU;50-59;844;1239;2083
2020-07-06;SO;50-59;339;566;905
2020-07-06;VA;50-59;931;1444;2375
2020-07-06;CyL;50-59;5637;8681;14318
2020-07-06;PA;60-69;287;327;614
2020-07-06;SA;60-69;742;885;1627
2020-07-06;SO;60-69;256;326;582
2020-07-06;VA;60-69;724;960;1684
2020-07-06;CyL;60-69;4504;5486;9990
2020-07-06;AV;70-79;267;291;558
2020-07-06;BU;70-79;406;389;795
2020-07-06;PA;70-79;191;216;407
2020-07-06;BU;>80;560;977;1537
2020-07-06;SA;>80;742;1310;2052
2020-07-06;VA;>80;655;1337;1992
2020-07-06;AV;0-9;130;114;244
2020-07-06;BU;0-9;236;174;410
2020-07-06;LE;0-9;254;230;484
2020-07-06;SE;0-9;154;142;296
2020-07-06;VA;0-9;472;405;877
2020-07-06;AV;10-19;121;92;213
2020-07-06;BU;10-19;209;204;413
2020-07-06;LE;10-19;196;204;400
2020-07-06;PA;10-19;93;73;166
2020-07-06;VA;10-19;307;311;618
2020-07-06;CyL;10-19;1396;1360;2756
2020-07-06;ZA;20-29;87;112;199
2020-07-06;LE;30-39;555;914;1469
2020-07-06;PA;30-39;251;330;581
2020-07-06;SO;30-39;185;301;486
2020-07-06;ZA;30-39;130;214;344
2020-07-06;CyL;30-39;3772;5583;9355
2020-07-06;SE;40-49;569;854;1423
2020-07-06;ZA;40-49;216;330;546
2020-07-06;CyL;40-49;5556;8041;13597
2020-07-06;AV;50-59;404;658;1062
2020-07-06;LE;50-59;848;1293;2141
2020-07-06;PA;50-59;353;484;837
2020-07-06;SE;50-59;722;1147;1869
2020-07-06;ZA;50-59;239;380;619
2020-07-06;BU;60-69;579;706;1285
2020-07-06;LE;60-69;738;925;1663
2020-07-06;ZA;60-69;222;258;480
2020-07-06;SA;70-79;504;561;1065
2020-07-06;ZA;70-79;157;153;310
2020-07-06;PA;>80;221;414;635
2020-07-06;SE;>80;607;963;1570
2020-07-06;ZA;>80;220;342;562
2020-07-06;CyL;>80;4520;7972;12492
2020-07-06;PA;0-9;80;49;129
2020-07-06;SA;0-9;283;314;597
2020-07-06;ZA;0-9;204;191;395
2020-07-06;SE;10-19;120;112;232
2020-07-06;ZA;10-19;76;83;159
2020-07-06;SA;20-29;389;533;922
2020-07-06;SO;20-29;137;195;332
2020-07-06;SA;30-39;605;906;1511
2020-07-06;AV;40-49;418;588;1006
2020-07-06;PA;40-49;359;446;805
2020-07-06;SA;40-49;824;1198;2022
2020-07-06;SA;50-59;957;1470;2427
2020-07-06;AV;60-69;367;433;800
2020-07-06;SE;60-69;589;666;1255
2020-07-06;LE;70-79;617;558;1175
2020-07-06;SE;70-79;400;389;789
2020-07-06;SO;70-79;166;157;323
2020-07-06;VA;70-79;554;630;1184
2020-07-06;CyL;70-79;3262;3344;6606
2020-07-06;AV;>80;393;635;1028
2020-07-06;LE;>80;760;1353;2113
2020-07-06;SO;>80;362;641;1003
2020-07-05;AV;0-9;130;113;243
2020-07-05;SA;0-9;282;314;596
2020-07-05;ZA;0-9;203;191;394
2020-07-05;BU;10-19;209;203;412
2020-07-05;SO;10-19;61;52;113
2020-07-05;ZA;10-19;76;83;159
2020-07-05;CyL;10-19;1388;1355;2743
2020-07-05;SA;20-29;388;533;921
2020-07-05;SE;20-29;227;332;559
2020-07-05;SO;20-29;136;193;329
2020-07-05;VA;20-29;473;681;1154
2020-07-05;CyL;20-29;2390;3248;5638
2020-07-05;AV;30-39;281;393;674
2020-07-05;LE;30-39;553;913;1466
2020-07-05;SO;30-39;184;300;484
2020-07-05;CyL;30-39;3765;5573;9338
2020-07-05;SA;40-49;824;1195;2019
2020-07-05;VA;40-49;1098;1608;2706
2020-07-05;ZA;40-49;216;330;546
2020-07-05;LE;50-59;845;1293;2138
2020-07-05;ZA;50-59;239;380;619
2020-07-05;BU;60-69;578;706;1284
2020-07-05;LE;60-69;735;924;1659
2020-07-05;SA;60-69;741;884;1625
2020-07-05;SE;60-69;588;665;1253
2020-07-05;SO;60-69;255;326;581
2020-07-05;LE;70-79;614;557;1171
2020-07-05;SE;70-79;399;387;786
2020-07-05;SO;70-79;166;157;323
2020-07-05;CyL;70-79;3257;3337;6594
2020-07-05;SA;>80;742;1310;2052
2020-07-05;BU;0-9;237;175;412
2020-07-05;PA;0-9;79;48;127
2020-07-05;SO;0-9;77;59;136
2020-07-05;CyL;0-9;1884;1676;3560
2020-07-05;AV;10-19;119;92;211
2020-07-05;LE;10-19;196;205;401
2020-07-05;PA;10-19;93;72;165
2020-07-05;SE;10-19;118;111;229
2020-07-05;VA;10-19;305;308;613
2020-07-05;AV;20-29;172;217;389
2020-07-05;BU;20-29;395;525;920
2020-07-05;BU;30-39;648;858;1506
2020-07-05;PA;30-39;250;327;577
2020-07-05;SE;30-39;346;522;868
2020-07-05;ZA;30-39;130;215;345
2020-07-05;BU;40-49;946;1229;2175
2020-07-05;PA;40-49;361;446;807
2020-07-05;SE;40-49;569;851;1420
2020-07-05;SE;50-59;715;1145;1860
2020-07-05;CyL;50-59;5623;8675;14298
2020-07-05;AV;60-69;367;432;799
2020-07-05;CyL;60-69;4495;5480;9975
2020-07-05;BU;70-79;405;385;790
2020-07-05;SA;70-79;504;561;1065
2020-07-05;VA;70-79;555;630;1185
2020-07-05;ZA;70-79;157;153;310
2020-07-05;PA;>80;222;416;638
2020-07-05;SE;>80;608;963;1571
2020-07-05;VA;>80;653;1336;1989
2020-07-05;CyL;>80;4518;7970;12488
2020-07-05;LE;0-9;252;229;481
2020-07-05;SE;0-9;154;141;295
2020-07-05;VA;0-9;470;406;876
2020-07-05;SA;10-19;211;229;440
2020-07-05;LE;20-29;355;472;827
2020-07-05;PA;20-29;157;183;340
2020-07-05;ZA;20-29;87;112;199
2020-07-05;SA;30-39;605;906;1511
2020-07-05;VA;30-39;768;1139;1907
2020-07-05;AV;40-49;416;588;1004
2020-07-05;LE;40-49;838;1309;2147
2020-07-05;SO;40-49;280;473;753
2020-07-05;CyL;40-49;5548;8029;13577
2020-07-05;AV;50-59;404;657;1061
2020-07-05;BU;50-59;842;1240;2082
2020-07-05;PA;50-59;352;482;834
2020-07-05;SA;50-59;957;1469;2426
2020-07-05;SO;50-59;340;565;905
2020-07-05;VA;50-59;929;1444;2373
2020-07-05;PA;60-69;286;326;612
2020-07-05;VA;60-69;723;959;1682
2020-07-05;ZA;60-69;222;258;480
2020-07-05;AV;70-79;267;291;558
2020-07-05;PA;70-79;190;216;406
2020-07-05;AV;>80;393;632;1025
2020-07-05;BU;>80;559;978;1537
2020-07-05;LE;>80;759;1353;2112
2020-07-05;SO;>80;362;641;1003
2020-07-05;ZA;>80;220;341;561
2020-07-02;LE;0-9;251;228;479
2020-07-02;VA;0-9;472;405;877
2020-07-02;ZA;0-9;203;190;393
2020-07-02;CyL;20-29;2377;3234;5611
2020-07-02;AV;30-39;281;392;673
2020-07-02;LE;30-39;554;910;1464
2020-07-02;PA;30-39;248;326;574
2020-07-02;SO;30-39;184;300;484
2020-07-02;VA;30-39;769;1139;1908
2020-07-02;AV;40-49;415;587;1002
2020-07-02;SE;40-49;568;850;1418
2020-07-02;ZA;40-49;216;330;546
2020-07-02;BU;50-59;839;1237;2076
2020-07-02;SA;50-59;958;1467;2425
2020-07-02;CyL;50-59;5610;8656;14266
2020-07-02;SO;60-69;255;326;581
2020-07-02;ZA;60-69;222;258;480
2020-07-02;AV;70-79;266;291;557
2020-07-02;SA;70-79;503;560;1063
2020-07-02;SE;70-79;394;384;778
2020-07-02;AV;>80;392;632;1024
2020-07-02;BU;>80;558;977;1535
2020-07-02;SE;>80;604;964;1568
2020-07-02;CyL;>80;4509;7959;12468
2020-07-02;AV;0-9;130;113;243
2020-07-02;BU;0-9;235;175;410
2020-07-02;PA;0-9;78;45;123
2020-07-02;SA;0-9;281;312;593
2020-07-02;SE;0-9;158;138;296
2020-07-02;BU;10-19;208;203;411
2020-07-02;LE;10-19;195;204;399
2020-07-02;PA;10-19;93;71;164
2020-07-02;SA;10-19;209;228;437
2020-07-02;SE;10-19;117;110;227
2020-07-02;VA;10-19;306;306;612
2020-07-02;AV;20-29;171;217;388
2020-07-02;SE;20-29;226;329;555
2020-07-02;SO;20-29;135;189;324
2020-07-02;BU;30-39;646;856;1502
2020-07-02;SA;30-39;603;905;1508
2020-07-02;SE;30-39;345;520;865
2020-07-02;LE;40-49;835;1309;2144
2020-07-02;SA;40-49;821;1193;2014
2020-07-02;SO;40-49;279;473;752
2020-07-02;CyL;40-49;5538;8021;13559
2020-07-02;AV;50-59;404;657;1061
2020-07-02;LE;50-59;842;1291;2133
2020-07-02;PA;50-59;349;480;829
2020-07-02;SO;50-59;340;563;903
2020-07-02;LE;60-69;734;923;1657
2020-07-02;VA;60-69;724;956;1680
2020-07-02;SO;70-79;166;156;322
2020-07-02;VA;70-79;556;629;1185
2020-07-02;PA;>80;220;414;634
2020-07-02;SA;>80;742;1306;2048
2020-07-02;ZA;>80;220;340;560
2020-07-02;SO;0-9;77;59;136
2020-07-02;CyL;0-9;1885;1665;3550
2020-07-02;AV;10-19;116;90;206
2020-07-02;SO;10-19;61;53;114
2020-07-02;ZA;10-19;76;83;159
2020-07-02;CyL;10-19;1381;1348;2729
2020-07-02;BU;20-29;395;522;917
2020-07-02;LE;20-29;353;473;826
2020-07-02;PA;20-29;157;181;338
2020-07-02;SA;20-29;387;532;919
2020-07-02;VA;20-29;468;680;1148
2020-07-02;ZA;20-29;85;111;196
2020-07-02;ZA;30-39;130;215;345
2020-07-02;CyL;30-39;3760;5563;9323
2020-07-02;BU;40-49;946;1228;2174
2020-07-02;PA;40-49;362;445;807
2020-07-02;VA;40-49;1096;1606;2702
2020-07-02;SE;50-59;711;1142;1853
2020-07-02;VA;50-59;928;1440;2368
2020-07-02;ZA;50-59;239;379;618
2020-07-02;AV;60-69;367;432;799
2020-07-02;BU;60-69;577;704;1281
2020-07-02;PA;60-69;288;327;615
2020-07-02;SA;60-69;738;883;1621
2020-07-02;SE;60-69;589;663;1252
2020-07-02;CyL;60-69;4494;5472;9966
2020-07-02;BU;70-79;405;385;790
2020-07-02;LE;70-79;613;556;1169
2020-07-02;PA;70-79;190;214;404
2020-07-02;ZA;70-79;156;153;309
2020-07-02;CyL;70-79;3249;3328;6577
2020-07-02;LE;>80;758;1352;2110
2020-07-02;SO;>80;362;639;1001
2020-07-02;VA;>80;653;1335;1988
2020-07-01;AV;0-9;130;113;243
2020-07-01;BU;0-9;235;174;409
2020-07-01;SO;0-9;77;58;135
2020-07-01;VA;0-9;469;405;874
2020-07-01;CyL;0-9;1878;1661;3539
2020-07-01;SO;10-19;61;52;113
2020-07-01;VA;10-19;304;306;610
2020-07-01;CyL;10-19;1377;1344;2721
2020-07-01;SO;20-29;133;189;322
2020-07-01;CyL;20-29;2374;3228;5602
2020-07-01;AV;30-39;280;390;670
2020-07-01;BU;30-39;646;854;1500
2020-07-01;LE;30-39;553;909;1462
2020-07-01;BU;40-49;948;1228;2176
2020-07-01;SE;40-49;567;848;1415
2020-07-01;SO;40-49;279;473;752
2020-07-01;CyL;40-49;5534;8018;13552
2020-07-01;AV;50-59;404;658;1062
2020-07-01;PA;50-59;348;478;826
2020-07-01;CyL;50-59;5602;8649;14251
2020-07-01;SO;60-69;254;326;580
2020-07-01;AV;70-79;266;291;557
2020-07-01;BU;70-79;405;384;789
2020-07-01;PA;70-79;190;213;403
2020-07-01;ZA;70-79;155;153;308
2020-07-01;CyL;70-79;3248;3322;6570
2020-07-01;BU;>80;558;976;1534
2020-07-01;SA;>80;742;1307;2049
2020-07-01;SE;>80;602;961;1563
2020-07-01;SO;>80;361;638;999
2020-07-01;VA;>80;652;1333;1985
2020-07-01;LE;0-9;250;228;478
2020-07-01;PA;0-9;78;44;122
2020-07-01;SA;0-9;281;311;592
2020-07-01;SE;0-9;156;138;294
2020-07-01;AV;10-19;116;90;206
2020-07-01;BU;10-19;208;203;411
2020-07-01;LE;10-19;194;203;397
2020-07-01;ZA;10-19;76;83;159
2020-07-01;AV;20-29;171;217;388
2020-07-01;BU;20-29;397;522;919
2020-07-01;LE;20-29;352;472;824
2020-07-01;SA;20-29;386;533;919
2020-07-01;ZA;20-29;85;110;195
2020-07-01;SA;30-39;603;904;1507
2020-07-01;SE;30-39;345;518;863
2020-07-01;SO;30-39;183;299;482
2020-07-01;VA;30-39;768;1141;1909
2020-07-01;ZA;30-39;130;215;345
2020-07-01;LE;40-49;833;1309;2142
2020-07-01;PA;40-49;363;445;808
2020-07-01;SA;40-49;822;1192;2014
2020-07-01;ZA;40-49;215;330;545
2020-07-01;BU;50-59;840;1236;2076
2020-07-01;SA;50-59;956;1465;2421
2020-07-01;SO;50-59;340;563;903
2020-07-01;AV;60-69;368;430;798
2020-07-01;BU;60-69;577;704;1281
2020-07-01;SA;60-69;739;882;1621
2020-07-01;SE;60-69;584;661;1245
2020-07-01;ZA;60-69;221;257;478
2020-07-01;LE;70-79;611;556;1167
2020-07-01;SO;70-79;167;155;322
2020-07-01;LE;>80;757;1352;2109
2020-07-01;CyL;>80;4504;7950;12454
2020-07-01;ZA;0-9;202;190;392
2020-07-01;PA;10-19;94;71;165
2020-07-01;SA;10-19;208;228;436
2020-07-01;SE;10-19;116;108;224
2020-07-01;PA;20-29;155;178;333
2020-07-01;SE;20-29;228;328;556
2020-07-01;VA;20-29;467;679;1146
2020-07-01;PA;30-39;248;326;574
2020-07-01;CyL;30-39;3756;5556;9312
2020-07-01;AV;40-49;413;587;1000
2020-07-01;VA;40-49;1094;1606;2700
2020-07-01;LE;50-59;840;1290;2130
2020-07-01;SE;50-59;709;1144;1853
2020-07-01;VA;50-59;925;1439;2364
2020-07-01;ZA;50-59;240;376;616
2020-07-01;LE;60-69;734;923;1657
2020-07-01;PA;60-69;282;324;606
2020-07-01;VA;60-69;726;956;1682
2020-07-01;CyL;60-69;4485;5463;9948
2020-07-01;SA;70-79;503;558;1061
2020-07-01;SE;70-79;394;384;778
2020-07-01;VA;70-79;557;628;1185
2020-07-01;AV;>80;392;632;1024
2020-07-01;PA;>80;220;411;631
2020-07-01;ZA;>80;220;340;560
2020-06-30;LE;0-9;250;228;478
2020-06-30;PA;0-9;78;41;119
2020-06-30;PA;10-19;94;70;164
2020-06-30;SO;10-19;60;52;112
2020-06-30;ZA;10-19;76;83;159
2020-06-30;VA;20-29;466;676;1142
2020-06-30;ZA;20-29;85;109;194
2020-06-30;AV;30-39;280;390;670
2020-06-30;LE;30-39;553;906;1459
2020-06-30;SA;30-39;603;905;1508
2020-06-30;ZA;30-39;131;215;346
2020-06-30;AV;40-49;413;584;997
2020-06-30;BU;40-49;945;1224;2169
2020-06-30;PA;40-49;363;447;810
2020-06-30;SE;40-49;566;848;1414
2020-06-30;VA;40-49;1092;1604;2696
2020-06-30;SO;50-59;340;562;902
2020-06-30;CyL;50-59;5598;8631;14229
2020-06-30;BU;60-69;578;704;1282
2020-06-30;CyL;60-69;4475;5457;9932
2020-06-30;BU;70-79;405;382;787
2020-06-30;PA;70-79;189;212;401
2020-06-30;SA;70-79;499;555;1054
2020-06-30;VA;70-79;556;626;1182
2020-06-30;CyL;70-79;3236;3308;6544
2020-06-30;SA;>80;742;1305;2047
2020-06-30;SE;>80;601;959;1560
2020-06-30;BU;0-9;231;173;404
2020-06-30;SE;0-9;154;136;290
2020-06-30;BU;10-19;207;202;409
2020-06-30;SA;10-19;207;224;431
2020-06-30;VA;10-19;305;306;611
2020-06-30;CyL;10-19;1374;1337;2711
2020-06-30;AV;20-29;170;217;387
2020-06-30;PA;20-29;153;178;331
2020-06-30;CyL;20-29;2364;3221;5585
2020-06-30;BU;30-39;642;854;1496
2020-06-30;LE;40-49;832;1307;2139
2020-06-30;SA;40-49;821;1191;2012
2020-06-30;AV;50-59;404;657;1061
2020-06-30;BU;50-59;838;1232;2070
2020-06-30;LE;50-59;841;1290;2131
2020-06-30;SA;50-59;954;1465;2419
2020-06-30;ZA;50-59;241;376;617
2020-06-30;AV;60-69;367;429;796
2020-06-30;LE;60-69;732;923;1655
2020-06-30;SA;60-69;737;882;1619
2020-06-30;SO;60-69;253;325;578
2020-06-30;ZA;60-69;221;257;478
2020-06-30;LE;70-79;609;555;1164
2020-06-30;SE;70-79;393;383;776
2020-06-30;AV;>80;392;633;1025
2020-06-30;BU;>80;556;976;1532
2020-06-30;PA;>80;218;413;631
2020-06-30;VA;>80;653;1334;1987
2020-06-30;ZA;>80;220;341;561
2020-06-30;CyL;>80;4499;7948;12447
2020-06-30;AV;0-9;130;110;240
2020-06-30;SA;0-9;281;311;592
2020-06-30;SO;0-9;77;58;135
2020-06-30;VA;0-9;466;404;870
2020-06-30;ZA;0-9;202;190;392
2020-06-30;CyL;0-9;1869;1651;3520
2020-06-30;AV;10-19;117;90;207
2020-06-30;LE;10-19;191;202;393
2020-06-30;SE;10-19;117;108;225
2020-06-30;BU;20-29;396;520;916
2020-06-30;LE;20-29;348;473;821
2020-06-30;SA;20-29;385;532;917
2020-06-30;SE;20-29;228;328;556
2020-06-30;SO;20-29;133;188;321
2020-06-30;PA;30-39;249;326;575
2020-06-30;SE;30-39;343;516;859
2020-06-30;SO;30-39;182;300;482
2020-06-30;VA;30-39;768;1140;1908
2020-06-30;CyL;30-39;3751;5552;9303
2020-06-30;SO;40-49;279;471;750
2020-06-30;ZA;40-49;215;330;545
2020-06-30;CyL;40-49;5526;8006;13532
2020-06-30;PA;50-59;347;476;823
2020-06-30;SE;50-59;708;1139;1847
2020-06-30;VA;50-59;925;1434;2359
2020-06-30;PA;60-69;281;322;603
2020-06-30;SE;60-69;584;660;1244
2020-06-30;VA;60-69;722;955;1677
2020-06-30;AV;70-79;264;289;553
2020-06-30;SO;70-79;166;154;320
2020-06-30;ZA;70-79;155;152;307
2020-06-30;LE;>80;756;1351;2107
2020-06-30;SO;>80;361;636;997
2020-06-29;AV;0-9;130;110;240
2020-06-29;PA;0-9;77;40;117
2020-06-29;SA;0-9;281;311;592
2020-06-29;ZA;0-9;202;189;391
2020-06-29;BU;10-19;207;201;408
2020-06-29;LE;10-19;191;202;393
2020-06-29;PA;10-19;91;70;161
2020-06-29;SE;10-19;116;108;224
2020-06-29;PA;20-29;153;178;331
2020-06-29;SO;20-29;133;188;321
2020-06-29;VA;30-39;766;1135;1901
2020-06-29;CyL;30-39;3741;5540;9281
2020-06-29;AV;40-49;412;584;996
2020-06-29;ZA;40-49;215;330;545
2020-06-29;AV;50-59;404;656;1060
2020-06-29;CyL;50-59;5595;8622;14217
2020-06-29;AV;60-69;366;429;795
2020-06-29;SA;60-69;737;880;1617
2020-06-29;VA;60-69;721;955;1676
2020-06-29;CyL;60-69;4465;5445;9910
2020-06-29;LE;70-79;608;555;1163
2020-06-29;PA;70-79;189;211;400
2020-06-29;VA;70-79;555;624;1179
2020-06-29;ZA;70-79;155;152;307
2020-06-29;CyL;70-79;3230;3303;6533
2020-06-29;AV;>80;392;633;1025
2020-06-29;LE;>80;752;1351;2103
2020-06-29;SA;>80;742;1302;2044
2020-06-29;VA;>80;651;1331;1982
2020-06-29;CyL;>80;4492;7942;12434
2020-06-29;CyL;0-9;1862;1646;3508
2020-06-29;SO;10-19;59;52;111
2020-06-29;VA;10-19;305;303;608
2020-06-29;CyL;10-19;1368;1328;2696
2020-06-29;AV;20-29;170;216;386
2020-06-29;CyL;20-29;2357;3211;5568
2020-06-29;AV;30-39;278;388;666
2020-06-29;SO;30-39;180;300;480
2020-06-29;ZA;30-39;129;215;344
2020-06-29;BU;40-49;945;1224;2169
2020-06-29;SA;40-49;820;1191;2011
2020-06-29;VA;40-49;1088;1603;2691
2020-06-29;BU;50-59;838;1231;2069
2020-06-29;SE;50-59;708;1138;1846
2020-06-29;BU;60-69;577;702;1279
2020-06-29;LE;60-69;731;922;1653
2020-06-29;PA;60-69;280;319;599
2020-06-29;AV;70-79;263;289;552
2020-06-29;SA;70-79;498;555;1053
2020-06-29;SE;70-79;392;384;776
2020-06-29;BU;>80;557;976;1533
2020-06-29;SE;>80;599;959;1558
2020-06-29;BU;0-9;229;170;399
2020-06-29;LE;0-9;247;229;476
2020-06-29;SE;0-9;153;135;288
2020-06-29;SO;0-9;78;60;138
2020-06-29;VA;0-9;465;402;867
2020-06-29;AV;10-19;116;90;206
2020-06-29;SA;10-19;207;219;426
2020-06-29;ZA;10-19;76;83;159
2020-06-29;BU;20-29;395;518;913
2020-06-29;LE;20-29;347;469;816
2020-06-29;SA;20-29;384;530;914
2020-06-29;SE;20-29;226;329;555
2020-06-29;VA;20-29;464;674;1138
2020-06-29;ZA;20-29;85;109;194
2020-06-29;BU;30-39;641;852;1493
2020-06-29;LE;30-39;552;905;1457
2020-06-29;PA;30-39;249;327;576
2020-06-29;SA;30-39;603;904;1507
2020-06-29;SE;30-39;343;514;857
2020-06-29;LE;40-49;833;1303;2136
2020-06-29;PA;40-49;360;444;804
2020-06-29;SE;40-49;566;846;1412
2020-06-29;SO;40-49;279;471;750
2020-06-29;CyL;40-49;5518;7996;13514
2020-06-29;LE;50-59;840;1285;2125
2020-06-29;PA;50-59;347;476;823
2020-06-29;SA;50-59;954;1464;2418
2020-06-29;SO;50-59;340;562;902
2020-06-29;VA;50-59;924;1435;2359
2020-06-29;ZA;50-59;240;375;615
2020-06-29;SE;60-69;581;657;1238
2020-06-29;SO;60-69;252;324;576
2020-06-29;ZA;60-69;220;257;477
2020-06-29;BU;70-79;404;381;785
2020-06-29;SO;70-79;166;152;318
2020-06-29;PA;>80;219;413;632
2020-06-29;SO;>80;361;636;997
2020-06-29;ZA;>80;219;341;560
2020-06-28;AV;0-9;129;112;241
2020-06-28;VA;0-9;463;398;861
2020-06-28;ZA;0-9;202;189;391
2020-06-28;AV;10-19;116;89;205
2020-06-28;SA;10-19;206;216;422
2020-06-28;ZA;10-19;76;83;159
2020-06-28;CyL;10-19;1365;1323;2688
2020-06-28;AV;20-29;169;216;385
2020-06-28;BU;20-29;395;517;912
2020-06-28;LE;20-29;345;470;815
2020-06-28;PA;20-29;152;181;333
2020-06-28;SE;20-29;226;328;554
2020-06-28;CyL;20-29;2345;3206;5551
2020-06-28;BU;30-39;641;852;1493
2020-06-28;LE;30-39;549;904;1453
2020-06-28;CyL;30-39;3732;5531;9263
2020-06-28;ZA;40-49;215;330;545
2020-06-28;BU;50-59;838;1230;2068
2020-06-28;LE;50-59;840;1284;2124
2020-06-28;SE;50-59;709;1136;1845
2020-06-28;SO;50-59;340;562;902
2020-06-28;BU;60-69;577;702;1279
2020-06-28;SE;60-69;581;657;1238
2020-06-28;SO;60-69;252;324;576
2020-06-28;CyL;60-69;4461;5434;9895
2020-06-28;AV;70-79;263;286;549
2020-06-28;LE;70-79;607;554;1161
2020-06-28;SA;70-79;495;551;1046
2020-06-28;VA;70-79;555;623;1178
2020-06-28;ZA;70-79;155;152;307
2020-06-28;AV;>80;392;633;1025
2020-06-28;BU;>80;557;976;1533
2020-06-28;LE;>80;752;1350;2102
2020-06-28;PA;>80;220;413;633
2020-06-28;SA;>80;741;1302;2043
2020-06-28;SO;>80;363;636;999
2020-06-28;VA;>80;651;1325;1976
2020-06-28;ZA;>80;219;341;560
2020-06-28;CyL;>80;4492;7937;12429
2020-06-28;BU;0-9;230;170;400
2020-06-28;LE;0-9;246;227;473
2020-06-28;SA;0-9;280;309;589
2020-06-28;SO;0-9;76;60;136
2020-06-28;BU;10-19;207;200;407
2020-06-28;PA;10-19;91;70;161
2020-06-28;SO;10-19;59;52;111
2020-06-28;VA;10-19;305;301;606
2020-06-28;VA;20-29;456;669;1125
2020-06-28;VA;30-39;761;1131;1892
2020-06-28;ZA;30-39;129;214;343
2020-06-28;BU;40-49;945;1223;2168
2020-06-28;LE;40-49;830;1302;2132
2020-06-28;AV;50-59;402;654;1056
2020-06-28;SA;50-59;949;1461;2410
2020-06-28;VA;50-59;921;1430;2351
2020-06-28;CyL;50-59;5587;8610;14197
2020-06-28;AV;60-69;366;429;795
2020-06-28;LE;60-69;729;920;1649
2020-06-28;PA;70-79;188;209;397
2020-06-28;PA;0-9;76;39;115
2020-06-28;SE;0-9;152;134;286
2020-06-28;CyL;0-9;1854;1638;3492
2020-06-28;LE;10-19;190;203;393
2020-06-28;SE;10-19;115;109;224
2020-06-28;SA;20-29;384;528;912
2020-06-28;SO;20-29;133;188;321
2020-06-28;ZA;20-29;85;109;194
2020-06-28;AV;30-39;277;388;665
2020-06-28;PA;30-39;248;327;575
2020-06-28;SA;30-39;603;903;1506
2020-06-28;SE;30-39;343;512;855
2020-06-28;SO;30-39;181;300;481
2020-06-28;AV;40-49;411;584;995
2020-06-28;PA;40-49;359;442;801
2020-06-28;SA;40-49;819;1190;2009
2020-06-28;SE;40-49;566;845;1411
2020-06-28;SO;40-49;279;469;748
2020-06-28;VA;40-49;1084;1598;2682
2020-06-28;CyL;40-49;5508;7983;13491
2020-06-28;PA;50-59;348;477;825
2020-06-28;ZA;50-59;240;376;616
2020-06-28;PA;60-69;280;316;596
2020-06-28;SA;60-69;737;876;1613
2020-06-28;VA;60-69;719;953;1672
2020-06-28;ZA;60-69;220;257;477
2020-06-28;BU;70-79;404;381;785
2020-06-28;SE;70-79;391;382;773
2020-06-28;SO;70-79;166;152;318
2020-06-28;CyL;70-79;3224;3290;6514
2020-06-28;SE;>80;597;961;1558
2020-06-25;SE;0-9;150;132;282
2020-06-25;SO;0-9;74;58;132
2020-06-25;VA;0-9;460;401;861
2020-06-25;SA;10-19;204;216;420
2020-06-25;SO;10-19;59;53;112
2020-06-25;ZA;10-19;76;82;158
2020-06-25;CyL;10-19;1345;1317;2662
2020-06-25;BU;20-29;396;516;912
2020-06-25;ZA;20-29;85;109;194
2020-06-25;CyL;20-29;2339;3197;5536
2020-06-25;AV;30-39;277;388;665
2020-06-25;BU;30-39;643;854;1497
2020-06-25;PA;30-39;247;323;570
2020-06-25;SE;30-39;341;511;852
2020-06-25;CyL;30-39;3723;5517;9240
2020-06-25;VA;40-49;1078;1592;2670
2020-06-25;ZA;40-49;215;327;542
2020-06-25;PA;50-59;344;475;819
2020-06-25;SE;50-59;707;1137;1844
2020-06-25;CyL;50-59;5566;8591;14157
2020-06-25;AV;60-69;363;427;790
2020-06-25;SO;60-69;252;325;577
2020-06-25;ZA;60-69;219;255;474
2020-06-25;AV;70-79;262;283;545
2020-06-25;LE;70-79;606;554;1160
2020-06-25;CyL;70-79;3220;3278;6498
2020-06-25;AV;>80;392;632;1024
2020-06-25;BU;>80;555;973;1528
2020-06-25;LE;>80;751;1346;2097
2020-06-25;PA;>80;219;413;632
2020-06-25;SA;>80;740;1300;2040
2020-06-25;SE;>80;594;955;1549
2020-06-25;CyL;>80;4480;7916;12396
2020-06-25;AV;0-9;128;110;238
2020-06-25;BU;0-9;227;170;397
2020-06-25;LE;0-9;248;226;474
2020-06-25;ZA;0-9;202;189;391
2020-06-25;PA;10-19;89;69;158
2020-06-25;AV;20-29;167;216;383
2020-06-25;LE;20-29;344;469;813
2020-06-25;PA;20-29;151;178;329
2020-06-25;SA;20-29;384;528;912
2020-06-25;SO;20-29;132;189;321
2020-06-25;LE;30-39;546;903;1449
2020-06-25;VA;30-39;758;1124;1882
2020-06-25;ZA;30-39;128;213;341
2020-06-25;AV;40-49;410;582;992
2020-06-25;BU;40-49;942;1221;2163
2020-06-25;PA;40-49;358;442;800
2020-06-25;SE;40-49;562;841;1403
2020-06-25;SO;40-49;278;468;746
2020-06-25;BU;50-59;837;1230;2067
2020-06-25;SA;50-59;948;1454;2402
2020-06-25;SO;50-59;338;559;897
2020-06-25;VA;50-59;914;1428;2342
2020-06-25;ZA;50-59;240;374;614
2020-06-25;LE;60-69;726;918;1644
2020-06-25;SA;60-69;737;873;1610
2020-06-25;SE;60-69;581;655;1236
2020-06-25;CyL;60-69;4447;5420;9867
2020-06-25;SA;70-79;495;551;1046
2020-06-25;SO;>80;361;636;997
2020-06-25;PA;0-9;74;41;115
2020-06-25;SA;0-9;280;308;588
2020-06-25;CyL;0-9;1843;1635;3478
2020-06-25;AV;10-19;114;88;202
2020-06-25;BU;10-19;206;199;405
2020-06-25;LE;10-19;188;203;391
2020-06-25;SE;10-19;110;108;218
2020-06-25;VA;10-19;299;299;598
2020-06-25;SE;20-29;222;325;547
2020-06-25;VA;20-29;458;667;1125
2020-06-25;SA;30-39;602;904;1506
2020-06-25;SO;30-39;181;297;478
2020-06-25;LE;40-49;831;1301;2132
2020-06-25;SA;40-49;814;1190;2004
2020-06-25;CyL;40-49;5488;7964;13452
2020-06-25;AV;50-59;399;652;1051
2020-06-25;LE;50-59;839;1282;2121
2020-06-25;BU;60-69;576;703;1279
2020-06-25;PA;60-69;275;317;592
2020-06-25;VA;60-69;718;947;1665
2020-06-25;BU;70-79;403;382;785
2020-06-25;PA;70-79;187;209;396
2020-06-25;SE;70-79;391;379;770
2020-06-25;SO;70-79;165;150;315
2020-06-25;VA;70-79;555;618;1173
2020-06-25;ZA;70-79;156;152;308
2020-06-25;VA;>80;649;1322;1971
2020-06-25;ZA;>80;219;339;558
2020-06-24;BU;0-9;226;170;396
2020-06-24;SE;0-9;150;134;284
2020-06-24;BU;10-19;206;197;403
2020-06-24;LE;10-19;185;204;389
2020-06-24;SE;10-19;110;106;216
2020-06-24;SO;10-19;59;52;111
2020-06-24;ZA;10-19;76;82;158
2020-06-24;CyL;10-19;1342;1312;2654
2020-06-24;AV;20-29;168;216;384
2020-06-24;SA;20-29;383;526;909
2020-06-24;SE;20-29;222;327;549
2020-06-24;SO;20-29;131;189;320
2020-06-24;SA;30-39;600;900;1500
2020-06-24;VA;30-39;758;1120;1878
2020-06-24;ZA;30-39;128;211;339
2020-06-24;SA;40-49;814;1187;2001
2020-06-24;VA;40-49;1077;1588;2665
2020-06-24;AV;50-59;397;651;1048
2020-06-24;LE;50-59;837;1282;2119
2020-06-24;SA;50-59;947;1453;2400
2020-06-24;VA;50-59;914;1425;2339
2020-06-24;ZA;50-59;239;373;612
2020-06-24;CyL;50-59;5558;8576;14134
2020-06-24;AV;60-69;362;427;789
2020-06-24;BU;60-69;575;703;1278
2020-06-24;PA;60-69;275;315;590
2020-06-24;ZA;60-69;219;256;475
2020-06-24;CyL;60-69;4444;5408;9852
2020-06-24;AV;70-79;262;281;543
2020-06-24;BU;70-79;403;380;783
2020-06-24;LE;70-79;605;552;1157
2020-06-24;PA;70-79;187;210;397
2020-06-24;SA;70-79;495;548;1043
2020-06-24;SO;70-79;165;149;314
2020-06-24;VA;70-79;553;616;1169
2020-06-24;CyL;70-79;3216;3267;6483
2020-06-24;PA;>80;219;412;631
2020-06-24;VA;>80;648;1322;1970
2020-06-24;AV;0-9;128;108;236
2020-06-24;PA;0-9;72;41;113
2020-06-24;ZA;0-9;201;188;389
2020-06-24;CyL;0-9;1844;1639;3483
2020-06-24;PA;10-19;91;69;160
2020-06-24;SA;10-19;204;216;420
2020-06-24;VA;10-19;297;298;595
2020-06-24;BU;20-29;396;515;911
2020-06-24;PA;20-29;148;177;325
2020-06-24;ZA;20-29;85;108;193
2020-06-24;CyL;20-29;2333;3192;5525
2020-06-24;AV;30-39;277;388;665
2020-06-24;BU;30-39;642;852;1494
2020-06-24;PA;30-39;246;321;567
2020-06-24;SE;30-39;340;508;848
2020-06-24;AV;40-49;410;581;991
2020-06-24;LE;40-49;828;1297;2125
2020-06-24;PA;40-49;358;442;800
2020-06-24;SE;40-49;560;837;1397
2020-06-24;SO;40-49;278;467;745
2020-06-24;CyL;40-49;5483;7945;13428
2020-06-24;BU;50-59;837;1228;2065
2020-06-24;PA;50-59;343;475;818
2020-06-24;SO;50-59;339;556;895
2020-06-24;SE;60-69;581;652;1233
2020-06-24;ZA;70-79;156;153;309
2020-06-24;AV;>80;392;631;1023
2020-06-24;BU;>80;554;972;1526
2020-06-24;LE;>80;749;1345;2094
2020-06-24;SA;>80;738;1300;2038
2020-06-24;SO;>80;360;637;997
2020-06-24;LE;0-9;253;235;488
2020-06-24;SA;0-9;279;307;586
2020-06-24;SO;0-9;74;57;131
2020-06-24;VA;0-9;461;399;860
2020-06-24;AV;10-19;114;88;202
2020-06-24;LE;20-29;344;469;813
2020-06-24;VA;20-29;456;665;1121
2020-06-24;LE;30-39;543;901;1444
2020-06-24;SO;30-39;181;297;478
2020-06-24;CyL;30-39;3715;5498;9213
2020-06-24;BU;40-49;943;1220;2163
2020-06-24;ZA;40-49;215;326;541
2020-06-24;SE;50-59;705;1133;1838
2020-06-24;LE;60-69;724;914;1638
2020-06-24;SA;60-69;738;873;1611
2020-06-24;SO;60-69;253;324;577
2020-06-24;VA;60-69;717;944;1661
2020-06-24;SE;70-79;390;378;768
2020-06-24;SE;>80;594;954;1548
2020-06-24;ZA;>80;219;338;557
2020-06-24;CyL;>80;4473;7911;12384
2020-06-23;LE;0-9;253;235;488
2020-06-23;SO;0-9;72;57;129
2020-06-23;ZA;0-9;201;189;390
2020-06-23;CyL;0-9;1838;1635;3473
2020-06-23;BU;10-19;207;197;404
2020-06-23;SA;10-19;202;216;418
2020-06-23;SE;10-19;111;106;217
2020-06-23;SO;10-19;58;51;109
2020-06-23;ZA;10-19;76;81;157
2020-06-23;AV;20-29;168;216;384
2020-06-23;BU;20-29;397;514;911
2020-06-23;VA;20-29;454;663;1117
2020-06-23;CyL;20-29;2330;3188;5518
2020-06-23;AV;30-39;276;388;664
2020-06-23;BU;30-39;642;852;1494
2020-06-23;VA;30-39;756;1120;1876
2020-06-23;CyL;30-39;3709;5497;9206
2020-06-23;AV;40-49;409;581;990
2020-06-23;ZA;40-49;216;324;540
2020-06-23;BU;50-59;836;1227;2063
2020-06-23;SE;50-59;703;1131;1834
2020-06-23;SO;50-59;338;555;893
2020-06-23;BU;60-69;576;701;1277
2020-06-23;PA;60-69;273;313;586
2020-06-23;CyL;60-69;4436;5393;9829
2020-06-23;BU;70-79;402;380;782
2020-06-23;SO;70-79;165;148;313
2020-06-23;LE;>80;747;1340;2087
2020-06-23;PA;>80;218;411;629
2020-06-23;SO;>80;360;635;995
2020-06-23;AV;0-9;126;109;235
2020-06-23;BU;0-9;227;166;393
2020-06-23;PA;0-9;71;40;111
2020-06-23;SA;0-9;279;307;586
2020-06-23;VA;0-9;460;400;860
2020-06-23;PA;10-19;90;69;159
2020-06-23;CyL;10-19;1336;1308;2644
2020-06-23;LE;20-29;344;469;813
2020-06-23;PA;20-29;148;177;325
2020-06-23;SE;20-29;222;327;549
2020-06-23;PA;30-39;246;320;566
2020-06-23;SE;30-39;341;508;849
2020-06-23;PA;40-49;360;439;799
2020-06-23;SA;40-49;814;1187;2001
2020-06-23;SE;40-49;558;829;1387
2020-06-23;SO;40-49;279;467;746
2020-06-23;CyL;40-49;5479;7922;13401
2020-06-23;PA;50-59;343;475;818
2020-06-23;VA;50-59;914;1422;2336
2020-06-23;ZA;50-59;238;373;611
2020-06-23;CyL;50-59;5552;8562;14114
2020-06-23;AV;60-69;361;427;788
2020-06-23;SO;60-69;251;321;572
2020-06-23;VA;60-69;716;941;1657
2020-06-23;ZA;60-69;218;255;473
2020-06-23;AV;70-79;261;281;542
2020-06-23;LE;70-79;601;551;1152
2020-06-23;VA;70-79;553;614;1167
2020-06-23;ZA;70-79;154;153;307
2020-06-23;VA;>80;649;1320;1969
2020-06-23;SE;0-9;149;132;281
2020-06-23;AV;10-19;114;88;202
2020-06-23;LE;10-19;183;202;385
2020-06-23;VA;10-19;295;298;593
2020-06-23;SA;20-29;382;526;908
2020-06-23;SO;20-29;130;188;318
2020-06-23;ZA;20-29;85;108;193
2020-06-23;LE;30-39;541;902;1443
2020-06-23;SA;30-39;598;899;1497
2020-06-23;SO;30-39;181;297;478
2020-06-23;ZA;30-39;128;211;339
2020-06-23;BU;40-49;940;1220;2160
2020-06-23;LE;40-49;825;1295;2120
2020-06-23;VA;40-49;1078;1580;2658
2020-06-23;AV;50-59;398;650;1048
2020-06-23;LE;50-59;836;1278;2114
2020-06-23;SA;50-59;946;1451;2397
2020-06-23;LE;60-69;723;915;1638
2020-06-23;SA;60-69;737;869;1606
2020-06-23;SE;60-69;581;651;1232
2020-06-23;PA;70-79;187;210;397
2020-06-23;SA;70-79;494;546;1040
2020-06-23;SE;70-79;388;376;764
2020-06-23;CyL;70-79;3205;3259;6464
2020-06-23;AV;>80;392;630;1022
2020-06-23;BU;>80;553;972;1525
2020-06-23;SA;>80;739;1297;2036
2020-06-23;SE;>80;592;952;1544
2020-06-23;ZA;>80;218;337;555
2020-06-23;CyL;>80;4468;7894;12362
2020-06-22;BU;0-9;224;167;391
2020-06-22;SA;0-9;278;305;583
2020-06-22;SE;0-9;144;130;274
2020-06-22;BU;10-19;203;197;400
2020-06-22;LE;10-19;181;202;383
2020-06-22;SE;10-19;109;104;213
2020-06-22;SO;10-19;58;51;109
2020-06-22;BU;20-29;398;513;911
2020-06-22;LE;20-29;343;468;811
2020-06-22;SE;20-29;220;323;543
2020-06-22;CyL;20-29;2322;3179;5501
2020-06-22;BU;30-39;642;848;1490
2020-06-22;LE;30-39;538;899;1437
2020-06-22;PA;30-39;246;319;565
2020-06-22;SE;30-39;339;507;846
2020-06-22;BU;40-49;939;1217;2156
2020-06-22;SA;40-49;813;1186;1999
2020-06-22;SE;40-49;557;827;1384
2020-06-22;ZA;40-49;215;323;538
2020-06-22;AV;50-59;397;650;1047
2020-06-22;LE;50-59;834;1273;2107
2020-06-22;PA;50-59;344;472;816
2020-06-22;SA;50-59;940;1449;2389
2020-06-22;ZA;50-59;238;373;611
2020-06-22;LE;60-69;720;915;1635
2020-06-22;SA;60-69;737;867;1604
2020-06-22;CyL;60-69;4427;5379;9806
2020-06-22;BU;70-79;403;381;784
2020-06-22;LE;0-9;252;234;486
2020-06-22;PA;0-9;71;39;110
2020-06-22;SO;0-9;73;57;130
2020-06-22;CyL;0-9;1826;1626;3452
2020-06-22;AV;10-19;112;88;200
2020-06-22;PA;10-19;89;68;157
2020-06-22;SA;10-19;202;216;418
2020-06-22;VA;10-19;292;297;589
2020-06-22;CyL;10-19;1322;1303;2625
2020-06-22;VA;20-29;453;662;1115
2020-06-22;ZA;20-29;85;108;193
2020-06-22;SA;30-39;599;897;1496
2020-06-22;SO;30-39;182;294;476
2020-06-22;VA;30-39;753;1118;1871
2020-06-22;AV;40-49;408;579;987
2020-06-22;SO;50-59;336;555;891
2020-06-22;AV;60-69;361;426;787
2020-06-22;BU;60-69;575;700;1275
2020-06-22;SE;60-69;578;648;1226
2020-06-22;SO;60-69;250;320;570
2020-06-22;VA;60-69;716;938;1654
2020-06-22;LE;70-79;598;547;1145
2020-06-22;SE;70-79;388;373;761
2020-06-22;AV;>80;392;629;1021
2020-06-22;BU;>80;552;972;1524
2020-06-22;LE;>80;744;1340;2084
2020-06-22;SA;>80;738;1297;2035
2020-06-22;ZA;>80;218;336;554
2020-06-22;CyL;>80;4462;7889;12351
2020-06-22;AV;0-9;126;107;233
2020-06-22;VA;0-9;457;399;856
2020-06-22;ZA;0-9;201;188;389
2020-06-22;ZA;10-19;76;80;156
2020-06-22;AV;20-29;166;215;381
2020-06-22;PA;20-29;148;177;325
2020-06-22;SA;20-29;381;525;906
2020-06-22;SO;20-29;128;188;316
2020-06-22;AV;30-39;276;389;665
2020-06-22;ZA;30-39;129;211;340
2020-06-22;CyL;30-39;3704;5482;9186
2020-06-22;LE;40-49;821;1294;2115
2020-06-22;PA;40-49;360;438;798
2020-06-22;SO;40-49;277;466;743
2020-06-22;VA;40-49;1075;1576;2651
2020-06-22;CyL;40-49;5465;7906;13371
2020-06-22;BU;50-59;835;1221;2056
2020-06-22;SE;50-59;699;1130;1829
2020-06-22;VA;50-59;913;1417;2330
2020-06-22;CyL;50-59;5536;8540;14076
2020-06-22;PA;60-69;273;312;585
2020-06-22;ZA;60-69;217;253;470
2020-06-22;AV;70-79;261;280;541
2020-06-22;PA;70-79;187;207;394
2020-06-22;SA;70-79;491;542;1033
2020-06-22;SO;70-79;165;148;313
2020-06-22;VA;70-79;551;612;1163
2020-06-22;ZA;70-79;152;151;303
2020-06-22;CyL;70-79;3196;3241;6437
2020-06-22;PA;>80;218;412;630
2020-06-22;SE;>80;591;951;1542
2020-06-22;SO;>80;360;635;995
2020-06-22;VA;>80;649;1317;1966
2020-06-21;SE;0-9;142;127;269
2020-06-21;PA;10-19;88;66;154
2020-06-21;SO;10-19;58;51;109
2020-06-21;PA;20-29;148;177;325
2020-06-21;SA;20-29;379;524;903
2020-06-21;VA;20-29;452;661;1113
2020-06-21;SA;30-39;597;897;1494
2020-06-21;SE;30-39;338;506;844
2020-06-21;SO;30-39;176;295;471
2020-06-21;VA;30-39;750;1107;1857
2020-06-21;ZA;30-39;129;210;339
2020-06-21;AV;40-49;407;576;983
2020-06-21;LE;40-49;818;1293;2111
2020-06-21;PA;40-49;358;438;796
2020-06-21;SA;40-49;809;1185;1994
2020-06-21;AV;50-59;394;648;1042
2020-06-21;LE;50-59;831;1270;2101
2020-06-21;SA;50-59;940;1446;2386
2020-06-21;SE;50-59;701;1128;1829
2020-06-21;SO;50-59;336;553;889
2020-06-21;CyL;50-59;5525;8516;14041
2020-06-21;LE;60-69;717;913;1630
2020-06-21;VA;60-69;710;938;1648
2020-06-21;LE;70-79;598;545;1143
2020-06-21;SA;70-79;489;540;1029
2020-06-21;LE;>80;743;1340;2083
2020-06-21;PA;>80;217;411;628
2020-06-21;SE;>80;588;947;1535
2020-06-21;VA;>80;649;1318;1967
2020-06-21;ZA;>80;218;336;554
2020-06-21;AV;0-9;126;107;233
2020-06-21;LE;0-9;251;231;482
2020-06-21;SA;0-9;278;304;582
2020-06-21;BU;10-19;202;197;399
2020-06-21;SE;10-19;106;103;209
2020-06-21;AV;20-29;165;215;380
2020-06-21;BU;20-29;396;514;910
2020-06-21;LE;20-29;343;468;811
2020-06-21;SE;20-29;219;323;542
2020-06-21;ZA;20-29;82;108;190
2020-06-21;AV;30-39;275;387;662
2020-06-21;LE;30-39;537;897;1434
2020-06-21;CyL;30-39;3689;5465;9154
2020-06-21;BU;40-49;937;1219;2156
2020-06-21;SE;40-49;557;829;1386
2020-06-21;ZA;40-49;216;323;539
2020-06-21;CyL;40-49;5447;7901;13348
2020-06-21;ZA;50-59;238;372;610
2020-06-21;AV;60-69;360;427;787
2020-06-21;BU;60-69;571;701;1272
2020-06-21;PA;60-69;272;314;586
2020-06-21;SA;60-69;736;863;1599
2020-06-21;SO;60-69;249;320;569
2020-06-21;ZA;60-69;217;253;470
2020-06-21;AV;70-79;261;279;540
2020-06-21;PA;70-79;186;207;393
2020-06-21;SE;70-79;386;372;758
2020-06-21;ZA;70-79;152;151;303
2020-06-21;AV;>80;393;629;1022
2020-06-21;BU;>80;550;972;1522
2020-06-21;CyL;>80;4455;7885;12340
2020-06-21;BU;0-9;222;170;392
2020-06-21;PA;0-9;71;41;112
2020-06-21;SO;0-9;73;57;130
2020-06-21;VA;0-9;457;393;850
2020-06-21;ZA;0-9;201;187;388
2020-06-21;CyL;0-9;1821;1617;3438
2020-06-21;AV;10-19;114;87;201
2020-06-21;LE;10-19;182;204;386
2020-06-21;SA;10-19;202;216;418
2020-06-21;VA;10-19;290;296;586
2020-06-21;ZA;10-19;76;80;156
2020-06-21;CyL;10-19;1318;1300;2618
2020-06-21;SO;20-29;128;188;316
2020-06-21;CyL;20-29;2312;3178;5490
2020-06-21;BU;30-39;640;847;1487
2020-06-21;PA;30-39;247;319;566
2020-06-21;SO;40-49;275;466;741
2020-06-21;VA;40-49;1070;1572;2642
2020-06-21;BU;50-59;832;1215;2047
2020-06-21;PA;50-59;346;473;819
2020-06-21;VA;50-59;907;1411;2318
2020-06-21;SE;60-69;577;648;1225
2020-06-21;CyL;60-69;4409;5377;9786
2020-06-21;BU;70-79;404;381;785
2020-06-21;SO;70-79;164;147;311
2020-06-21;VA;70-79;553;611;1164
2020-06-21;CyL;70-79;3193;3233;6426
2020-06-21;SA;>80;737;1297;2034
2020-06-21;SO;>80;360;635;995
2020-06-18;BU;0-9;222;169;391
2020-06-18;SA;0-9;279;304;583
2020-06-18;ZA;0-9;201;186;387
2020-06-18;BU;10-19;201;197;398
2020-06-18;SE;10-19;104;102;206
2020-06-18;BU;20-29;394;512;906
2020-06-18;SA;20-29;379;524;903
2020-06-18;ZA;20-29;82;108;190
2020-06-18;AV;30-39;272;386;658
2020-06-18;PA;30-39;245;318;563
2020-06-18;SO;30-39;173;295;468
2020-06-18;LE;40-49;812;1292;2104
2020-06-18;SO;40-49;273;465;738
2020-06-18;ZA;40-49;216;323;539
2020-06-18;VA;50-59;900;1402;2302
2020-06-18;AV;60-69;358;425;783
2020-06-18;LE;60-69;713;910;1623
2020-06-18;SA;70-79;483;538;1021
2020-06-18;VA;70-79;549;606;1155
2020-06-18;ZA;70-79;151;149;300
2020-06-18;VA;>80;647;1316;1963
2020-06-18;AV;0-9;124;107;231
2020-06-18;VA;0-9;456;391;847
2020-06-18;CyL;0-9;1818;1612;3430
2020-06-18;ZA;10-19;76;80;156
2020-06-18;CyL;10-19;1309;1292;2601
2020-06-18;LE;20-29;344;465;809
2020-06-18;PA;20-29;146;173;319
2020-06-18;SO;20-29;127;185;312
2020-06-18;VA;20-29;448;658;1106
2020-06-18;SA;30-39;596;897;1493
2020-06-18;ZA;30-39;129;210;339
2020-06-18;AV;40-49;408;575;983
2020-06-18;PA;40-49;356;437;793
2020-06-18;SA;40-49;809;1179;1988
2020-06-18;VA;40-49;1065;1568;2633
2020-06-18;AV;50-59;395;647;1042
2020-06-18;PA;50-59;344;472;816
2020-06-18;SA;50-59;933;1441;2374
2020-06-18;SE;50-59;697;1123;1820
2020-06-18;SO;50-59;337;553;890
2020-06-18;ZA;50-59;237;372;609
2020-06-18;SA;60-69;734;864;1598
2020-06-18;VA;60-69;706;935;1641
2020-06-18;ZA;60-69;218;251;469
2020-06-18;AV;70-79;261;275;536
2020-06-18;SO;70-79;163;147;310
2020-06-18;AV;>80;391;623;1014
2020-06-18;PA;>80;217;411;628
2020-06-18;SA;>80;734;1295;2029
2020-06-18;SE;>80;589;946;1535
2020-06-18;SO;>80;358;635;993
2020-06-18;ZA;>80;217;335;552
2020-06-18;LE;0-9;250;231;481
2020-06-18;PA;0-9;71;40;111
2020-06-18;SE;0-9;142;127;269
2020-06-18;SO;0-9;73;57;130
2020-06-18;AV;10-19;112;87;199
2020-06-18;LE;10-19;182;202;384
2020-06-18;PA;10-19;88;67;155
2020-06-18;SA;10-19;200;214;414
2020-06-18;SO;10-19;58;47;105
2020-06-18;VA;10-19;288;296;584
2020-06-18;AV;20-29;164;214;378
2020-06-18;SE;20-29;217;319;536
2020-06-18;CyL;20-29;2301;3158;5459
2020-06-18;BU;30-39;639;845;1484
2020-06-18;LE;30-39;537;894;1431
2020-06-18;SE;30-39;337;503;840
2020-06-18;VA;30-39;744;1100;1844
2020-06-18;CyL;30-39;3672;5448;9120
2020-06-18;BU;40-49;933;1217;2150
2020-06-18;SE;40-49;555;825;1380
2020-06-18;CyL;40-49;5427;7881;13308
2020-06-18;BU;50-59;829;1219;2048
2020-06-18;LE;50-59;830;1270;2100
2020-06-18;CyL;50-59;5502;8499;14001
2020-06-18;BU;60-69;569;698;1267
2020-06-18;PA;60-69;272;312;584
2020-06-18;SE;60-69;576;643;1219
2020-06-18;SO;60-69;245;318;563
2020-06-18;CyL;60-69;4391;5356;9747
2020-06-18;BU;70-79;402;379;781
2020-06-18;LE;70-79;597;543;1140
2020-06-18;PA;70-79;184;208;392
2020-06-18;SE;70-79;384;369;753
2020-06-18;CyL;70-79;3174;3214;6388
2020-06-18;BU;>80;549;970;1519
2020-06-18;LE;>80;741;1337;2078
2020-06-18;CyL;>80;4443;7868;12311
2020-06-17;AV;0-9;124;107;231
2020-06-17;SA;0-9;279;304;583
2020-06-17;CyL;0-9;1812;1601;3413
2020-06-17;BU;10-19;199;197;396
2020-06-17;PA;10-19;88;64;152
2020-06-17;BU;20-29;390;513;903
2020-06-17;LE;20-29;344;463;807
2020-06-17;SO;20-29;128;185;313
2020-06-17;VA;20-29;445;657;1102
2020-06-17;ZA;20-29;79;107;186
2020-06-17;BU;30-39;637;843;1480
2020-06-17;LE;30-39;536;893;1429
2020-06-17;SA;30-39;595;893;1488
2020-06-17;VA;30-39;740;1096;1836
2020-06-17;CyL;30-39;3664;5438;9102
2020-06-17;BU;40-49;932;1216;2148
2020-06-17;PA;40-49;353;437;790
2020-06-17;VA;40-49;1064;1562;2626
2020-06-17;CyL;40-49;5411;7870;13281
2020-06-17;LE;50-59;828;1267;2095
2020-06-17;ZA;50-59;236;372;608
2020-06-17;CyL;50-59;5483;8480;13963
2020-06-17;AV;60-69;358;424;782
2020-06-17;PA;60-69;272;310;582
2020-06-17;CyL;60-69;4380;5336;9716
2020-06-17;LE;70-79;597;544;1141
2020-06-17;SA;70-79;480;534;1014
2020-06-17;BU;>80;551;969;1520
2020-06-17;ZA;>80;216;335;551
2020-06-17;BU;0-9;222;167;389
2020-06-17;LE;0-9;249;229;478
2020-06-17;SO;0-9;71;57;128
2020-06-17;ZA;0-9;201;186;387
2020-06-17;SA;10-19;199;213;412
2020-06-17;SE;10-19;102;101;203
2020-06-17;SO;10-19;58;48;106
2020-06-17;VA;10-19;286;291;577
2020-06-17;CyL;10-19;1299;1281;2580
2020-06-17;AV;20-29;163;213;376
2020-06-17;PA;20-29;146;173;319
2020-06-17;SE;20-29;218;316;534
2020-06-17;CyL;20-29;2292;3150;5442
2020-06-17;PA;30-39;246;317;563
2020-06-17;SO;30-39;173;296;469
2020-06-17;AV;40-49;407;575;982
2020-06-17;SA;40-49;803;1177;1980
2020-06-17;BU;50-59;828;1215;2043
2020-06-17;SE;50-59;695;1120;1815
2020-06-17;SO;50-59;336;554;890
2020-06-17;VA;50-59;891;1399;2290
2020-06-17;SA;60-69;734;862;1596
2020-06-17;SE;60-69;574;638;1212
2020-06-17;VA;60-69;703;931;1634
2020-06-17;AV;70-79;260;273;533
2020-06-17;PA;70-79;183;206;389
2020-06-17;VA;70-79;546;603;1149
2020-06-17;PA;>80;219;410;629
2020-06-17;SA;>80;732;1293;2025
2020-06-17;SE;>80;585;940;1525
2020-06-17;PA;0-9;71;39;110
2020-06-17;SE;0-9;142;123;265
2020-06-17;VA;0-9;453;389;842
2020-06-17;AV;10-19;111;87;198
2020-06-17;LE;10-19;180;200;380
2020-06-17;ZA;10-19;76;80;156
2020-06-17;SA;20-29;379;523;902
2020-06-17;AV;30-39;272;386;658
2020-06-17;SE;30-39;337;504;841
2020-06-17;ZA;30-39;128;210;338
2020-06-17;LE;40-49;810;1292;2102
2020-06-17;SE;40-49;554;824;1378
2020-06-17;SO;40-49;273;462;735
2020-06-17;ZA;40-49;215;325;540
2020-06-17;AV;50-59;395;646;1041
2020-06-17;PA;50-59;344;470;814
2020-06-17;SA;50-59;930;1437;2367
2020-06-17;BU;60-69;568;695;1263
2020-06-17;LE;60-69;711;909;1620
2020-06-17;SO;60-69;244;317;561
2020-06-17;ZA;60-69;216;250;466
2020-06-17;BU;70-79;402;376;778
2020-06-17;SE;70-79;382;367;749
2020-06-17;SO;70-79;163;147;310
2020-06-17;ZA;70-79;150;149;299
2020-06-17;CyL;70-79;3163;3199;6362
2020-06-17;AV;>80;391;622;1013
2020-06-17;LE;>80;741;1336;2077
2020-06-17;SO;>80;357;634;991
2020-06-17;VA;>80;645;1314;1959
2020-06-17;CyL;>80;4437;7853;12290
2020-06-16;AV;0-9;124;107;231
2020-06-16;AV;10-19;111;87;198
2020-06-16;BU;10-19;196;196;392
2020-06-16;SA;10-19;198;213;411
2020-06-16;SO;10-19;58;48;106
2020-06-16;VA;10-19;286;290;576
2020-06-16;AV;20-29;162;213;375
2020-06-16;BU;20-29;385;511;896
2020-06-16;PA;20-29;145;172;317
2020-06-16;AV;30-39;272;385;657
2020-06-16;LE;30-39;534;892;1426
2020-06-16;VA;30-39;737;1096;1833
2020-06-16;ZA;30-39;128;210;338
2020-06-16;BU;40-49;931;1214;2145
2020-06-16;LE;40-49;809;1289;2098
2020-06-16;SA;40-49;802;1180;1982
2020-06-16;SE;40-49;553;820;1373
2020-06-16;SO;40-49;273;459;732
2020-06-16;CyL;40-49;5397;7850;13247
2020-06-16;ZA;50-59;234;372;606
2020-06-16;BU;60-69;569;695;1264
2020-06-16;PA;60-69;271;308;579
2020-06-16;SA;60-69;732;860;1592
2020-06-16;SO;60-69;244;316;560
2020-06-16;VA;60-69;704;928;1632
2020-06-16;AV;70-79;260;272;532
2020-06-16;BU;70-79;400;376;776
2020-06-16;SE;70-79;380;366;746
2020-06-16;CyL;70-79;3157;3185;6342
2020-06-16;AV;>80;391;619;1010
2020-06-16;SA;>80;731;1292;2023
2020-06-16;SE;>80;586;940;1526
2020-06-16;CyL;>80;4431;7841;12272
2020-06-16;LE;0-9;249;229;478
2020-06-16;PA;0-9;71;39;110
2020-06-16;SA;0-9;281;304;585
2020-06-16;SO;0-9;69;55;124
2020-06-16;VA;0-9;451;386;837
2020-06-16;ZA;0-9;201;186;387
2020-06-16;PA;10-19;88;64;152
2020-06-16;SE;10-19;101;98;199
2020-06-16;CyL;10-19;1294;1276;2570
2020-06-16;SA;20-29;378;520;898
2020-06-16;SE;20-29;215;315;530
2020-06-16;VA;20-29;445;656;1101
2020-06-16;ZA;20-29;79;107;186
2020-06-16;SA;30-39;592;890;1482
2020-06-16;SE;30-39;335;501;836
2020-06-16;CyL;30-39;3656;5425;9081
2020-06-16;AV;40-49;406;574;980
2020-06-16;PA;40-49;350;431;781
2020-06-16;ZA;40-49;215;325;540
2020-06-16;BU;50-59;827;1216;2043
2020-06-16;LE;50-59;824;1263;2087
2020-06-16;CyL;50-59;5469;8458;13927
2020-06-16;AV;60-69;359;424;783
2020-06-16;ZA;60-69;216;250;466
2020-06-16;CyL;60-69;4377;5318;9695
2020-06-16;SO;70-79;163;146;309
2020-06-16;BU;>80;549;968;1517
2020-06-16;LE;>80;740;1336;2076
2020-06-16;PA;>80;216;409;625
2020-06-16;VA;>80;644;1310;1954
2020-06-16;ZA;>80;216;335;551
2020-06-16;BU;0-9;222;166;388
2020-06-16;SE;0-9;140;122;262
2020-06-16;CyL;0-9;1808;1594;3402
2020-06-16;LE;10-19;180;200;380
2020-06-16;ZA;10-19;76;80;156
2020-06-16;LE;20-29;343;461;804
2020-06-16;SO;20-29;128;183;311
2020-06-16;CyL;20-29;2280;3138;5418
2020-06-16;BU;30-39;635;842;1477
2020-06-16;PA;30-39;249;315;564
2020-06-16;SO;30-39;174;294;468
2020-06-16;VA;40-49;1058;1558;2616
2020-06-16;AV;50-59;393;643;1036
2020-06-16;PA;50-59;346;470;816
2020-06-16;SA;50-59;931;1433;2364
2020-06-16;SE;50-59;690;1118;1808
2020-06-16;SO;50-59;335;549;884
2020-06-16;VA;50-59;889;1394;2283
2020-06-16;LE;60-69;710;905;1615
2020-06-16;SE;60-69;572;632;1204
2020-06-16;LE;70-79;595;539;1134
2020-06-16;PA;70-79;184;205;389
2020-06-16;SA;70-79;480;531;1011
2020-06-16;VA;70-79;547;601;1148
2020-06-16;ZA;70-79;148;149;297
2020-06-16;SO;>80;358;632;990
2020-06-15;PA;0-9;71;38;109
2020-06-15;SO;0-9;69;54;123
2020-06-15;AV;10-19;111;87;198
2020-06-15;SA;10-19;198;211;409
2020-06-15;SE;10-19;100;98;198
2020-06-15;VA;10-19;287;289;576
2020-06-15;ZA;10-19;76;80;156
2020-06-15;PA;20-29;144;172;316
2020-06-15;BU;30-39;633;842;1475
2020-06-15;LE;30-39;535;891;1426
2020-06-15;ZA;30-39;128;211;339
2020-06-15;AV;40-49;406;573;979
2020-06-15;SE;40-49;551;818;1369
2020-06-15;SO;40-49;274;457;731
2020-06-15;BU;50-59;828;1211;2039
2020-06-15;SE;50-59;691;1115;1806
2020-06-15;SO;50-59;333;548;881
2020-06-15;VA;50-59;884;1387;2271
2020-06-15;LE;60-69;706;897;1603
2020-06-15;PA;60-69;270;309;579
2020-06-15;SA;60-69;732;856;1588
2020-06-15;SE;70-79;378;362;740
2020-06-15;VA;70-79;546;599;1145
2020-06-15;ZA;70-79;148;149;297
2020-06-15;CyL;70-79;3148;3170;6318
2020-06-15;SO;>80;357;631;988
2020-06-15;CyL;>80;4414;7809;12223
2020-06-15;BU;0-9;223;165;388
2020-06-15;SE;0-9;138;122;260
2020-06-15;VA;0-9;450;383;833
2020-06-15;ZA;0-9;201;186;387
2020-06-15;LE;10-19;180;199;379
2020-06-15;SO;10-19;56;47;103
2020-06-15;AV;20-29;162;213;375
2020-06-15;VA;20-29;443;651;1094
2020-06-15;CyL;20-29;2270;3130;5400
2020-06-15;SE;30-39;333;499;832
2020-06-15;SO;30-39;174;293;467
2020-06-15;CyL;30-39;3650;5415;9065
2020-06-15;BU;40-49;929;1213;2142
2020-06-15;CyL;40-49;5385;7828;13213
2020-06-15;LE;50-59;821;1259;2080
2020-06-15;PA;50-59;344;467;811
2020-06-15;ZA;50-59;233;372;605
2020-06-15;CyL;50-59;5449;8433;13882
2020-06-15;AV;60-69;358;423;781
2020-06-15;BU;60-69;566;688;1254
2020-06-15;VA;60-69;700;923;1623
2020-06-15;ZA;60-69;216;250;466
2020-06-15;PA;70-79;183;206;389
2020-06-15;SA;70-79;478;529;1007
2020-06-15;SO;70-79;163;146;309
2020-06-15;BU;>80;547;969;1516
2020-06-15;LE;>80;739;1335;2074
2020-06-15;SA;>80;729;1287;2016
2020-06-15;ZA;>80;216;335;551
2020-06-15;AV;0-9;122;106;228
2020-06-15;LE;0-9;247;227;474
2020-06-15;SA;0-9;281;304;585
2020-06-15;CyL;0-9;1802;1585;3387
2020-06-15;BU;10-19;193;193;386
2020-06-15;PA;10-19;87;63;150
2020-06-15;CyL;10-19;1288;1267;2555
2020-06-15;BU;20-29;384;510;894
2020-06-15;LE;20-29;341;461;802
2020-06-15;SA;20-29;376;519;895
2020-06-15;SE;20-29;214;313;527
2020-06-15;SO;20-29;127;183;310
2020-06-15;ZA;20-29;79;108;187
2020-06-15;AV;30-39;272;381;653
2020-06-15;PA;30-39;248;315;563
2020-06-15;SA;30-39;591;890;1481
2020-06-15;VA;30-39;736;1093;1829
2020-06-15;LE;40-49;805;1284;2089
2020-06-15;PA;40-49;349;430;779
2020-06-15;SA;40-49;801;1180;1981
2020-06-15;VA;40-49;1057;1549;2606
2020-06-15;ZA;40-49;213;324;537
2020-06-15;AV;50-59;391;643;1034
2020-06-15;SA;50-59;924;1431;2355
2020-06-15;SE;60-69;568;631;1199
2020-06-15;SO;60-69;244;316;560
2020-06-15;CyL;60-69;4360;5293;9653
2020-06-15;AV;70-79;258;267;525
2020-06-15;BU;70-79;400;374;774
2020-06-15;LE;70-79;594;538;1132
2020-06-15;AV;>80;390;619;1009
2020-06-15;PA;>80;216;407;623
2020-06-15;SE;>80;583;932;1515
2020-06-15;VA;>80;637;1294;1931
2020-06-14;BU;0-9;221;165;386
2020-06-14;LE;0-9;249;227;476
2020-06-14;PA;0-9;69;38;107
2020-06-14;SO;0-9;72;56;128
2020-06-14;VA;0-9;450;384;834
2020-06-14;PA;10-19;85;62;147
2020-06-14;SO;10-19;56;46;102
2020-06-14;AV;20-29;161;212;373
2020-06-14;SA;30-39;590;889;1479
2020-06-14;SO;40-49;274;457;731
2020-06-14;AV;50-59;391;643;1034
2020-06-14;SA;50-59;920;1425;2345
2020-06-14;VA;50-59;882;1380;2262
2020-06-14;ZA;50-59;232;371;603
2020-06-14;PA;60-69;269;307;576
2020-06-14;SA;60-69;729;854;1583
2020-06-14;ZA;60-69;215;249;464
2020-06-14;BU;70-79;400;375;775
2020-06-14;SO;70-79;162;144;306
2020-06-14;VA;70-79;545;597;1142
2020-06-14;CyL;70-79;3144;3157;6301
2020-06-14;AV;>80;390;615;1005
2020-06-14;LE;>80;737;1331;2068
2020-06-14;PA;>80;216;407;623
2020-06-14;ZA;>80;215;335;550
2020-06-14;ZA;0-9;201;186;387
2020-06-14;AV;10-19;110;88;198
2020-06-14;BU;10-19;192;194;386
2020-06-14;LE;10-19;177;198;375
2020-06-14;SA;10-19;197;208;405
2020-06-14;ZA;10-19;76;80;156
2020-06-14;BU;20-29;387;509;896
2020-06-14;LE;20-29;337;460;797
2020-06-14;PA;20-29;144;174;318
2020-06-14;SA;20-29;377;517;894
2020-06-14;SO;20-29;126;183;309
2020-06-14;VA;20-29;438;650;1088
2020-06-14;CyL;20-29;2261;3127;5388
2020-06-14;BU;30-39;635;844;1479
2020-06-14;LE;30-39;535;883;1418
2020-06-14;PA;30-39;244;312;556
2020-06-14;SE;30-39;331;498;829
2020-06-14;VA;30-39;735;1088;1823
2020-06-14;ZA;30-39;126;210;336
2020-06-14;CyL;30-39;3642;5397;9039
2020-06-14;AV;40-49;407;572;979
2020-06-14;BU;40-49;927;1209;2136
2020-06-14;PA;40-49;347;425;772
2020-06-14;ZA;40-49;212;322;534
2020-06-14;SE;50-59;689;1115;1804
2020-06-14;CyL;50-59;5437;8406;13843
2020-06-14;BU;60-69;564;687;1251
2020-06-14;LE;60-69;704;895;1599
2020-06-14;SE;60-69;567;632;1199
2020-06-14;SO;60-69;243;316;559
2020-06-14;VA;60-69;697;920;1617
2020-06-14;CyL;60-69;4345;5282;9627
2020-06-14;AV;70-79;259;267;526
2020-06-14;PA;70-79;183;205;388
2020-06-14;SA;70-79;477;528;1005
2020-06-14;SE;70-79;378;357;735
2020-06-14;ZA;70-79;147;146;293
2020-06-14;BU;>80;547;965;1512
2020-06-14;SO;>80;356;631;987
2020-06-14;AV;0-9;123;106;229
2020-06-14;SA;0-9;280;303;583
2020-06-14;SE;0-9;135;120;255
2020-06-14;CyL;0-9;1800;1585;3385
2020-06-14;SE;10-19;99;98;197
2020-06-14;VA;10-19;286;289;575
2020-06-14;CyL;10-19;1278;1263;2541
2020-06-14;SE;20-29;212;314;526
2020-06-14;ZA;20-29;79;108;187
2020-06-14;AV;30-39;273;380;653
2020-06-14;SO;30-39;173;293;466
2020-06-14;LE;40-49;804;1275;2079
2020-06-14;SA;40-49;801;1179;1980
2020-06-14;SE;40-49;551;816;1367
2020-06-14;VA;40-49;1049;1539;2588
2020-06-14;CyL;40-49;5372;7794;13166
2020-06-14;BU;50-59;828;1202;2030
2020-06-14;LE;50-59;821;1257;2078
2020-06-14;PA;50-59;341;466;807
2020-06-14;SO;50-59;333;547;880
2020-06-14;AV;60-69;357;422;779
2020-06-14;LE;70-79;593;538;1131
2020-06-14;SA;>80;729;1287;2016
2020-06-14;SE;>80;583;930;1513
2020-06-14;VA;>80;638;1295;1933
2020-06-14;CyL;>80;4411;7796;12207
2020-06-11;AV;0-9;124;105;229
2020-06-11;SA;0-9;277;303;580
2020-06-11;ZA;0-9;200;185;385
2020-06-11;AV;10-19;110;87;197
2020-06-11;LE;10-19;176;198;374
2020-06-11;PA;10-19;84;61;145
2020-06-11;SE;10-19;99;97;196
2020-06-11;ZA;10-19;75;80;155
2020-06-11;SA;20-29;377;518;895
2020-06-11;VA;20-29;443;650;1093
2020-06-11;ZA;20-29;79;107;186
2020-06-11;CyL;20-29;2255;3116;5371
2020-06-11;AV;30-39;274;382;656
2020-06-11;BU;30-39;635;843;1478
2020-06-11;VA;30-39;731;1084;1815
2020-06-11;ZA;30-39;126;210;336
2020-06-11;CyL;30-39;3632;5384;9016
2020-06-11;VA;40-49;1044;1534;2578
2020-06-11;LE;50-59;814;1250;2064
2020-06-11;BU;60-69;563;683;1246
2020-06-11;SO;60-69;241;313;554
2020-06-11;ZA;60-69;214;249;463
2020-06-11;CyL;60-69;4323;5261;9584
2020-06-11;BU;70-79;400;374;774
2020-06-11;ZA;70-79;147;146;293
2020-06-11;CyL;70-79;3132;3142;6274
2020-06-11;BU;>80;547;964;1511
2020-06-11;SE;>80;583;928;1511
2020-06-11;SO;>80;356;630;986
2020-06-11;ZA;>80;215;335;550
2020-06-11;BU;0-9;221;168;389
2020-06-11;BU;10-19;192;193;385
2020-06-11;SA;10-19;196;208;404
2020-06-11;AV;20-29;158;211;369
2020-06-11;BU;20-29;386;506;892
2020-06-11;PA;20-29;144;172;316
2020-06-11;SO;20-29;122;183;305
2020-06-11;LE;30-39;535;879;1414
2020-06-11;PA;30-39;243;311;554
2020-06-11;SA;30-39;587;890;1477
2020-06-11;SE;30-39;328;492;820
2020-06-11;SO;30-39;173;293;466
2020-06-11;AV;40-49;403;570;973
2020-06-11;BU;40-49;927;1207;2134
2020-06-11;PA;40-49;346;424;770
2020-06-11;SA;40-49;801;1176;1977
2020-06-11;SE;40-49;548;812;1360
2020-06-11;SO;40-49;272;454;726
2020-06-11;ZA;40-49;212;320;532
2020-06-11;BU;50-59;827;1201;2028
2020-06-11;SO;50-59;329;541;870
2020-06-11;VA;50-59;879;1378;2257
2020-06-11;CyL;50-59;5409;8372;13781
2020-06-11;PA;60-69;263;304;567
2020-06-11;SA;60-69;729;854;1583
2020-06-11;SE;60-69;564;630;1194
2020-06-11;VA;60-69;695;918;1613
2020-06-11;AV;70-79;259;267;526
2020-06-11;SA;70-79;475;527;1002
2020-06-11;LE;>80;737;1325;2062
2020-06-11;PA;>80;217;406;623
2020-06-11;SA;>80;729;1285;2014
2020-06-11;CyL;>80;4410;7779;12189
2020-06-11;LE;0-9;246;225;471
2020-06-11;PA;0-9;69;38;107
2020-06-11;SE;0-9;133;119;252
2020-06-11;SO;0-9;69;55;124
2020-06-11;VA;0-9;450;382;832
2020-06-11;CyL;0-9;1789;1580;3369
2020-06-11;SO;10-19;55;45;100
2020-06-11;VA;10-19;281;288;569
2020-06-11;CyL;10-19;1268;1257;2525
2020-06-11;LE;20-29;334;456;790
2020-06-11;SE;20-29;212;313;525
2020-06-11;LE;40-49;801;1268;2069
2020-06-11;CyL;40-49;5354;7765;13119
2020-06-11;AV;50-59;390;640;1030
2020-06-11;PA;50-59;341;467;808
2020-06-11;SA;50-59;916;1421;2337
2020-06-11;SE;50-59;683;1107;1790
2020-06-11;ZA;50-59;230;367;597
2020-06-11;AV;60-69;355;420;775
2020-06-11;LE;60-69;699;890;1589
2020-06-11;LE;70-79;591;533;1124
2020-06-11;PA;70-79;180;200;380
2020-06-11;SE;70-79;376;356;732
2020-06-11;SO;70-79;162;144;306
2020-06-11;VA;70-79;542;595;1137
2020-06-11;AV;>80;389;614;1003
2020-06-11;VA;>80;637;1292;1929
2020-06-10;LE;0-9;247;224;471
2020-06-10;BU;10-19;191;193;384
2020-06-10;SE;10-19;98;97;195
2020-06-10;ZA;10-19;75;79;154
2020-06-10;CyL;10-19;1261;1249;2510
2020-06-10;BU;20-29;381;502;883
2020-06-10;LE;20-29;329;453;782
2020-06-10;SO;20-29;121;181;302
2020-06-10;ZA;20-29;79;106;185
2020-06-10;CyL;20-29;2247;3101;5348
2020-06-10;BU;30-39;632;840;1472
2020-06-10;LE;30-39;532;875;1407
2020-06-10;SE;30-39;327;490;817
2020-06-10;ZA;30-39;126;208;334
2020-06-10;CyL;30-39;3616;5366;8982
2020-06-10;SA;40-49;798;1168;1966
2020-06-10;SE;40-49;546;810;1356
2020-06-10;VA;40-49;1038;1532;2570
2020-06-10;LE;50-59;808;1239;2047
2020-06-10;PA;50-59;335;462;797
2020-06-10;SA;50-59;913;1417;2330
2020-06-10;VA;50-59;874;1373;2247
2020-06-10;ZA;50-59;230;366;596
2020-06-10;BU;60-69;563;681;1244
2020-06-10;PA;60-69;262;303;565
2020-06-10;SA;60-69;725;851;1576
2020-06-10;SE;60-69;560;627;1187
2020-06-10;ZA;60-69;213;249;462
2020-06-10;LE;70-79;591;533;1124
2020-06-10;PA;70-79;181;198;379
2020-06-10;BU;>80;548;964;1512
2020-06-10;LE;>80;735;1322;2057
2020-06-10;ZA;>80;215;336;551
2020-06-10;CyL;>80;4402;7766;12168
2020-06-10;AV;0-9;123;107;230
2020-06-10;BU;0-9;221;168;389
2020-06-10;SA;0-9;276;301;577
2020-06-10;CyL;0-9;1782;1572;3354
2020-06-10;LE;10-19;174;196;370
2020-06-10;PA;10-19;82;61;143
2020-06-10;SO;10-19;55;45;100
2020-06-10;SA;20-29;376;520;896
2020-06-10;VA;20-29;444;648;1092
2020-06-10;PA;30-39;242;310;552
2020-06-10;SA;30-39;585;889;1474
2020-06-10;BU;40-49;929;1207;2136
2020-06-10;PA;40-49;347;419;766
2020-06-10;BU;50-59;825;1194;2019
2020-06-10;SE;50-59;681;1103;1784
2020-06-10;SO;50-59;329;540;869
2020-06-10;AV;60-69;355;419;774
2020-06-10;SO;60-69;240;309;549
2020-06-10;VA;60-69;692;915;1607
2020-06-10;SE;70-79;375;354;729
2020-06-10;SO;70-79;162;144;306
2020-06-10;CyL;70-79;3122;3126;6248
2020-06-10;PA;>80;215;407;622
2020-06-10;VA;>80;636;1291;1927
2020-06-10;PA;0-9;70;37;107
2020-06-10;SE;0-9;133;117;250
2020-06-10;SO;0-9;66;53;119
2020-06-10;VA;0-9;446;381;827
2020-06-10;ZA;0-9;200;184;384
2020-06-10;AV;10-19;110;85;195
2020-06-10;SA;10-19;196;206;402
2020-06-10;VA;10-19;280;287;567
2020-06-10;AV;20-29;159;211;370
2020-06-10;PA;20-29;145;170;315
2020-06-10;SE;20-29;213;310;523
2020-06-10;AV;30-39;273;381;654
2020-06-10;SO;30-39;172;292;464
2020-06-10;VA;30-39;727;1081;1808
2020-06-10;AV;40-49;400;566;966
2020-06-10;LE;40-49;798;1262;2060
2020-06-10;SO;40-49;270;452;722
2020-06-10;ZA;40-49;211;320;531
2020-06-10;CyL;40-49;5337;7736;13073
2020-06-10;AV;50-59;391;639;1030
2020-06-10;CyL;50-59;5386;8333;13719
2020-06-10;LE;60-69;699;881;1580
2020-06-10;CyL;60-69;4309;5235;9544
2020-06-10;AV;70-79;258;266;524
2020-06-10;BU;70-79;396;374;770
2020-06-10;SA;70-79;472;525;997
2020-06-10;VA;70-79;540;588;1128
2020-06-10;ZA;70-79;147;144;291
2020-06-10;AV;>80;389;610;999
2020-06-10;SA;>80;727;1284;2011
2020-06-10;SE;>80;582;924;1506
2020-06-10;SO;>80;355;628;983
2020-06-09;AV;0-9;122;103;225
2020-06-09;BU;0-9;223;169;392
2020-06-09;AV;10-19;111;85;196
2020-06-09;BU;10-19;190;192;382
2020-06-09;LE;10-19;172;192;364
2020-06-09;BU;20-29;381;495;876
2020-06-09;PA;20-29;144;170;314
2020-06-09;AV;30-39;273;381;654
2020-06-09;BU;30-39;630;838;1468
2020-06-09;PA;30-39;239;309;548
2020-06-09;SA;30-39;585;888;1473
2020-06-09;SO;30-39;171;291;462
2020-06-09;ZA;30-39;125;207;332
2020-06-09;BU;40-49;927;1204;2131
2020-06-09;PA;40-49;346;418;764
2020-06-09;SA;40-49;796;1165;1961
2020-06-09;ZA;40-49;212;320;532
2020-06-09;CyL;40-49;5320;7709;13029
2020-06-09;SA;50-59;911;1412;2323
2020-06-09;SE;60-69;558;625;1183
2020-06-09;SO;60-69;239;308;547
2020-06-09;ZA;60-69;213;249;462
2020-06-09;PA;70-79;182;198;380
2020-06-09;SA;70-79;471;523;994
2020-06-09;SO;70-79;160;141;301
2020-06-09;VA;70-79;537;586;1123
2020-06-09;CyL;70-79;3115;3111;6226
2020-06-09;PA;>80;213;406;619
2020-06-09;ZA;>80;215;336;551
2020-06-09;LE;0-9;247;226;473
2020-06-09;SO;0-9;65;53;118
2020-06-09;VA;0-9;438;376;814
2020-06-09;ZA;0-9;200;184;384
2020-06-09;CyL;0-9;1771;1564;3335
2020-06-09;PA;10-19;81;60;141
2020-06-09;SE;10-19;97;96;193
2020-06-09;VA;10-19;278;281;559
2020-06-09;ZA;10-19;74;79;153
2020-06-09;CyL;10-19;1250;1234;2484
2020-06-09;AV;20-29;159;210;369
2020-06-09;LE;20-29;328;448;776
2020-06-09;SE;20-29;212;309;521
2020-06-09;SO;20-29;120;180;300
2020-06-09;SE;30-39;325;492;817
2020-06-09;SE;40-49;543;809;1352
2020-06-09;SO;40-49;267;450;717
2020-06-09;VA;40-49;1036;1527;2563
2020-06-09;LE;50-59;805;1228;2033
2020-06-09;PA;50-59;333;457;790
2020-06-09;SO;50-59;329;537;866
2020-06-09;VA;50-59;871;1366;2237
2020-06-09;CyL;50-59;5369;8296;13665
2020-06-09;LE;60-69;693;876;1569
2020-06-09;SA;60-69;724;849;1573
2020-06-09;BU;70-79;396;372;768
2020-06-09;SE;70-79;374;353;727
2020-06-09;ZA;70-79;147;143;290
2020-06-09;BU;>80;547;961;1508
2020-06-09;LE;>80;731;1314;2045
2020-06-09;SA;>80;727;1283;2010
2020-06-09;SE;>80;581;924;1505
2020-06-09;VA;>80;637;1289;1926
2020-06-09;PA;0-9;69;36;105
2020-06-09;SA;0-9;275;301;576
2020-06-09;SE;0-9;132;116;248
2020-06-09;SA;10-19;194;205;399
2020-06-09;SO;10-19;53;44;97
2020-06-09;SA;20-29;375;519;894
2020-06-09;VA;20-29;437;645;1082
2020-06-09;ZA;20-29;79;105;184
2020-06-09;CyL;20-29;2235;3081;5316
2020-06-09;LE;30-39;529;867;1396
2020-06-09;VA;30-39;723;1076;1799
2020-06-09;CyL;30-39;3600;5349;8949
2020-06-09;AV;40-49;400;564;964
2020-06-09;LE;40-49;793;1252;2045
2020-06-09;AV;50-59;389;638;1027
2020-06-09;BU;50-59;822;1192;2014
2020-06-09;SE;50-59;680;1100;1780
2020-06-09;ZA;50-59;229;366;595
2020-06-09;AV;60-69;352;418;770
2020-06-09;BU;60-69;561;681;1242
2020-06-09;PA;60-69;261;302;563
2020-06-09;VA;60-69;690;912;1602
2020-06-09;CyL;60-69;4291;5220;9511
2020-06-09;AV;70-79;258;265;523
2020-06-09;LE;70-79;590;530;1120
2020-06-09;AV;>80;390;609;999
2020-06-09;SO;>80;354;626;980
2020-06-09;CyL;>80;4395;7748;12143
2020-06-08;BU;0-9;222;167;389
2020-06-08;SO;0-9;62;51;113
2020-06-08;CyL;0-9;1758;1552;3310
2020-06-08;BU;10-19;189;192;381
2020-06-08;LE;10-19;171;190;361
2020-06-08;VA;10-19;276;279;555
2020-06-08;AV;20-29;159;210;369
2020-06-08;BU;20-29;377;494;871
2020-06-08;LE;20-29;323;438;761
2020-06-08;LE;30-39;530;864;1394
2020-06-08;PA;30-39;237;309;546
2020-06-08;SA;30-39;583;886;1469
2020-06-08;VA;30-39;724;1076;1800
2020-06-08;ZA;30-39;125;206;331
2020-06-08;LE;40-49;791;1239;2030
2020-06-08;VA;40-49;1030;1526;2556
2020-06-08;CyL;40-49;5303;7677;12980
2020-06-08;AV;50-59;387;636;1023
2020-06-08;LE;50-59;800;1212;2012
2020-06-08;PA;50-59;332;455;787
2020-06-08;SA;50-59;909;1409;2318
2020-06-08;SE;50-59;677;1097;1774
2020-06-08;CyL;50-59;5350;8261;13611
2020-06-08;LE;60-69;691;868;1559
2020-06-08;VA;60-69;687;910;1597
2020-06-08;CyL;60-69;4272;5200;9472
2020-06-08;PA;70-79;182;195;377
2020-06-08;SE;70-79;373;353;726
2020-06-08;SO;70-79;160;140;300
2020-06-08;ZA;70-79;146;143;289
2020-06-08;CyL;70-79;3102;3101;6203
2020-06-08;BU;>80;546;959;1505
2020-06-08;LE;>80;727;1313;2040
2020-06-08;SA;>80;726;1280;2006
2020-06-08;SO;>80;354;626;980
2020-06-08;VA;>80;635;1288;1923
2020-06-08;ZA;>80;215;335;550
2020-06-08;CyL;>80;4387;7736;12123
2020-06-08;SA;0-9;275;301;576
2020-06-08;ZA;0-9;200;184;384
2020-06-08;AV;10-19;110;82;192
2020-06-08;PA;10-19;80;60;140
2020-06-08;SA;10-19;193;201;394
2020-06-08;SE;10-19;97;94;191
2020-06-08;ZA;10-19;74;79;153
2020-06-08;CyL;10-19;1242;1221;2463
2020-06-08;SO;20-29;120;179;299
2020-06-08;ZA;20-29;78;105;183
2020-06-08;AV;30-39;272;380;652
2020-06-08;SE;30-39;323;492;815
2020-06-08;CyL;30-39;3589;5330;8919
2020-06-08;SE;40-49;539;803;1342
2020-06-08;SO;40-49;263;448;711
2020-06-08;SO;50-59;328;535;863
2020-06-08;AV;60-69;351;416;767
2020-06-08;BU;60-69;559;681;1240
2020-06-08;PA;60-69;261;301;562
2020-06-08;SE;60-69;552;623;1175
2020-06-08;AV;70-79;258;265;523
2020-06-08;BU;70-79;395;369;764
2020-06-08;VA;70-79;535;586;1121
2020-06-08;AV;>80;390;608;998
2020-06-08;SE;>80;581;923;1504
2020-06-08;AV;0-9;123;102;225
2020-06-08;LE;0-9;244;226;470
2020-06-08;PA;0-9;68;35;103
2020-06-08;SE;0-9;130;113;243
2020-06-08;VA;0-9;434;373;807
2020-06-08;SO;10-19;52;44;96
2020-06-08;PA;20-29;144;168;312
2020-06-08;SA;20-29;373;518;891
2020-06-08;SE;20-29;212;309;521
2020-06-08;VA;20-29;430;638;1068
2020-06-08;CyL;20-29;2216;3059;5275
2020-06-08;BU;30-39;625;830;1455
2020-06-08;SO;30-39;170;287;457
2020-06-08;AV;40-49;399;562;961
2020-06-08;BU;40-49;924;1202;2126
2020-06-08;PA;40-49;349;418;767
2020-06-08;SA;40-49;796;1160;1956
2020-06-08;ZA;40-49;212;319;531
2020-06-08;BU;50-59;821;1190;2011
2020-06-08;VA;50-59;867;1361;2228
2020-06-08;ZA;50-59;229;366;595
2020-06-08;SA;60-69;721;847;1568
2020-06-08;SO;60-69;238;306;544
2020-06-08;ZA;60-69;212;248;460
2020-06-08;LE;70-79;587;529;1116
2020-06-08;SA;70-79;466;521;987
2020-06-08;PA;>80;213;404;617
2020-06-07;LE;0-9;242;229;471
2020-06-07;SA;0-9;276;299;575
2020-06-07;SE;0-9;129;112;241
2020-06-07;CyL;0-9;1753;1545;3298
2020-06-07;AV;10-19;108;81;189
2020-06-07;BU;10-19;189;191;380
2020-06-07;SE;10-19;96;94;190
2020-06-07;CyL;10-19;1231;1212;2443
2020-06-07;LE;20-29;319;436;755
2020-06-07;SA;20-29;370;518;888
2020-06-07;ZA;20-29;77;105;182
2020-06-07;CyL;20-29;2192;3053;5245
2020-06-07;AV;30-39;272;379;651
2020-06-07;AV;40-49;399;561;960
2020-06-07;PA;40-49;347;417;764
2020-06-07;SA;40-49;796;1159;1955
2020-06-07;CyL;40-49;5274;7656;12930
2020-06-07;AV;50-59;383;635;1018
2020-06-07;SA;50-59;910;1405;2315
2020-06-07;SO;50-59;327;534;861
2020-06-07;CyL;50-59;5333;8239;13572
2020-06-07;AV;60-69;348;413;761
2020-06-07;PA;60-69;261;297;558
2020-06-07;CyL;60-69;4254;5175;9429
2020-06-07;ZA;70-79;145;142;287
2020-06-07;BU;>80;543;958;1501
2020-06-07;LE;>80;726;1312;2038
2020-06-07;SA;>80;722;1278;2000
2020-06-07;SE;>80;580;921;1501
2020-06-07;VA;>80;632;1283;1915
2020-06-07;ZA;>80;214;334;548
2020-06-07;AV;0-9;123;100;223
2020-06-07;BU;0-9;221;167;388
2020-06-07;PA;0-9;68;35;103
2020-06-07;ZA;0-9;199;183;382
2020-06-07;LE;10-19;167;187;354
2020-06-07;PA;10-19;80;59;139
2020-06-07;AV;20-29;160;209;369
2020-06-07;BU;20-29;372;494;866
2020-06-07;SE;20-29;208;311;519
2020-06-07;SO;20-29;119;179;298
2020-06-07;VA;20-29;425;633;1058
2020-06-07;BU;30-39;625;829;1454
2020-06-07;LE;30-39;529;861;1390
2020-06-07;PA;30-39;238;309;547
2020-06-07;SA;30-39;582;883;1465
2020-06-07;SO;30-39;169;290;459
2020-06-07;VA;30-39;724;1075;1799
2020-06-07;SE;40-49;536;800;1336
2020-06-07;SO;40-49;260;447;707
2020-06-07;VA;40-49;1026;1518;2544
2020-06-07;BU;50-59;819;1185;2004
2020-06-07;PA;50-59;330;456;786
2020-06-07;VA;50-59;863;1359;2222
2020-06-07;ZA;50-59;228;365;593
2020-06-07;LE;60-69;687;862;1549
2020-06-07;SA;60-69;715;843;1558
2020-06-07;SE;60-69;549;622;1171
2020-06-07;VA;60-69;686;905;1591
2020-06-07;ZA;60-69;212;247;459
2020-06-07;BU;70-79;393;368;761
2020-06-07;LE;70-79;585;526;1111
2020-06-07;AV;>80;389;607;996
2020-06-07;SO;>80;354;626;980
2020-06-07;SO;0-9;61;51;112
2020-06-07;VA;0-9;434;369;803
2020-06-07;SA;10-19;194;199;393
2020-06-07;SO;10-19;53;43;96
2020-06-07;VA;10-19;270;279;549
2020-06-07;ZA;10-19;74;79;153
2020-06-07;PA;20-29;142;168;310
2020-06-07;SE;30-39;318;492;810
2020-06-07;ZA;30-39;125;206;331
2020-06-07;CyL;30-39;3582;5324;8906
2020-06-07;BU;40-49;919;1201;2120
2020-06-07;LE;40-49;781;1237;2018
2020-06-07;ZA;40-49;210;316;526
2020-06-07;LE;50-59;799;1207;2006
2020-06-07;SE;50-59;674;1093;1767
2020-06-07;BU;60-69;558;680;1238
2020-06-07;SO;60-69;238;306;544
2020-06-07;AV;70-79;257;266;523
2020-06-07;PA;70-79;181;194;375
2020-06-07;SA;70-79;465;521;986
2020-06-07;SE;70-79;371;351;722
2020-06-07;SO;70-79;158;138;296
2020-06-07;VA;70-79;532;584;1116
2020-06-07;CyL;70-79;3087;3090;6177
2020-06-07;PA;>80;213;404;617
2020-06-07;CyL;>80;4373;7723;12096
2020-06-06;PA;0-9;68;35;103
2020-06-06;BU;10-19;189;191;380
2020-06-06;LE;10-19;167;187;354
2020-06-06;PA;10-19;80;59;139
2020-06-06;SA;10-19;194;199;393
2020-06-06;BU;20-29;372;494;866
2020-06-06;PA;20-29;142;168;310
2020-06-06;ZA;20-29;77;104;181
2020-06-06;AV;30-39;272;379;651
2020-06-06;LE;30-39;529;859;1388
2020-06-06;SO;30-39;170;291;461
2020-06-06;BU;40-49;919;1201;2120
2020-06-06;PA;40-49;346;417;763
2020-06-06;PA;50-59;329;454;783
2020-06-06;AV;60-69;348;413;761
2020-06-06;LE;60-69;686;862;1548
2020-06-06;SE;60-69;547;620;1167
2020-06-06;CyL;60-69;4249;5173;9422
2020-06-06;LE;70-79;585;526;1111
2020-06-06;PA;70-79;181;194;375
2020-06-06;CyL;70-79;3085;3088;6173
2020-06-06;PA;>80;213;404;617
2020-06-06;BU;0-9;220;167;387
2020-06-06;SE;0-9;129;112;241
2020-06-06;SO;0-9;61;51;112
2020-06-06;VA;0-9;433;369;802
2020-06-06;AV;10-19;108;81;189
2020-06-06;SE;10-19;95;93;188
2020-06-06;SO;10-19;53;42;95
2020-06-06;CyL;10-19;1229;1210;2439
2020-06-06;AV;20-29;160;209;369
2020-06-06;LE;20-29;319;434;753
2020-06-06;SA;20-29;369;518;887
2020-06-06;VA;20-29;425;633;1058
2020-06-06;CyL;20-29;2189;3047;5236
2020-06-06;BU;30-39;624;829;1453
2020-06-06;SA;30-39;582;883;1465
2020-06-06;ZA;30-39;125;206;331
2020-06-06;CyL;30-39;3581;5323;8904
2020-06-06;SE;40-49;536;800;1336
2020-06-06;VA;40-49;1026;1517;2543
2020-06-06;CyL;40-49;5270;7653;12923
2020-06-06;AV;50-59;382;635;1017
2020-06-06;LE;50-59;799;1207;2006
2020-06-06;SA;50-59;910;1405;2315
2020-06-06;CyL;50-59;5329;8233;13562
2020-06-06;BU;60-69;558;680;1238
2020-06-06;PA;60-69;261;297;558
2020-06-06;SO;60-69;236;305;541
2020-06-06;ZA;60-69;212;247;459
2020-06-06;BU;70-79;393;368;761
2020-06-06;SA;70-79;465;521;986
2020-06-06;SO;70-79;158;136;294
2020-06-06;VA;70-79;532;584;1116
2020-06-06;ZA;70-79;145;142;287
2020-06-06;AV;>80;389;607;996
2020-06-06;BU;>80;541;957;1498
2020-06-06;LE;>80;726;1310;2036
2020-06-06;SO;>80;354;626;980
2020-06-06;VA;>80;632;1282;1914
2020-06-06;CyL;>80;4370;7715;12085
2020-06-06;AV;0-9;122;100;222
2020-06-06;LE;0-9;242;228;470
2020-06-06;SA;0-9;275;299;574
2020-06-06;ZA;0-9;198;183;381
2020-06-06;CyL;0-9;1748;1544;3292
2020-06-06;VA;10-19;269;279;548
2020-06-06;ZA;10-19;74;79;153
2020-06-06;SE;20-29;208;309;517
2020-06-06;SO;20-29;117;178;295
2020-06-06;PA;30-39;238;308;546
2020-06-06;SE;30-39;318;493;811
2020-06-06;VA;30-39;723;1075;1798
2020-06-06;AV;40-49;399;561;960
2020-06-06;LE;40-49;779;1237;2016
2020-06-06;SA;40-49;796;1159;1955
2020-06-06;SO;40-49;259;445;704
2020-06-06;ZA;40-49;210;316;526
2020-06-06;BU;50-59;819;1184;2003
2020-06-06;SE;50-59;674;1092;1766
2020-06-06;SO;50-59;326;532;858
2020-06-06;VA;50-59;862;1359;2221
2020-06-06;ZA;50-59;228;365;593
2020-06-06;SA;60-69;715;844;1559
2020-06-06;VA;60-69;686;905;1591
2020-06-06;AV;70-79;256;266;522
2020-06-06;SE;70-79;370;351;721
2020-06-06;SA;>80;722;1277;1999
2020-06-06;SE;>80;579;918;1497
2020-06-06;ZA;>80;214;334;548
2020-06-05;AV;0-9;122;100;222
2020-06-05;PA;0-9;68;35;103
2020-06-05;ZA;0-9;198;183;381
2020-06-05;AV;10-19;108;81;189
2020-06-05;BU;10-19;188;191;379
2020-06-05;LE;10-19;165;186;351
2020-06-05;SE;10-19;96;93;189
2020-06-05;VA;10-19;269;279;548
2020-06-05;BU;20-29;373;494;867
2020-06-05;SO;20-29;117;177;294
2020-06-05;BU;30-39;624;829;1453
2020-06-05;PA;30-39;235;308;543
2020-06-05;SO;30-39;170;291;461
2020-06-05;ZA;30-39;125;206;331
2020-06-05;CyL;30-39;3577;5320;8897
2020-06-05;BU;40-49;919;1200;2119
2020-06-05;ZA;40-49;210;316;526
2020-06-05;AV;50-59;381;635;1016
2020-06-05;BU;50-59;815;1184;1999
2020-06-05;LE;50-59;796;1201;1997
2020-06-05;PA;50-59;329;453;782
2020-06-05;ZA;50-59;227;364;591
2020-06-05;SO;60-69;235;304;539
2020-06-05;LE;70-79;585;527;1112
2020-06-05;BU;>80;541;957;1498
2020-06-05;LE;>80;726;1310;2036
2020-06-05;SA;>80;722;1277;1999
2020-06-05;SA;0-9;275;299;574
2020-06-05;CyL;0-9;1748;1543;3291
2020-06-05;PA;10-19;80;59;139
2020-06-05;SA;10-19;193;199;392
2020-06-05;SO;10-19;53;42;95
2020-06-05;ZA;10-19;74;79;153
2020-06-05;CyL;10-19;1226;1209;2435
2020-06-05;LE;20-29;319;434;753
2020-06-05;LE;30-39;529;859;1388
2020-06-05;VA;30-39;723;1075;1798
2020-06-05;AV;40-49;399;561;960
2020-06-05;PA;40-49;343;417;760
2020-06-05;SE;40-49;535;798;1333
2020-06-05;VA;40-49;1026;1517;2543
2020-06-05;CyL;40-49;5264;7642;12906
2020-06-05;SA;50-59;907;1405;2312
2020-06-05;SE;50-59;674;1092;1766
2020-06-05;SO;50-59;325;528;853
2020-06-05;AV;60-69;346;413;759
2020-06-05;BU;60-69;558;680;1238
2020-06-05;SA;60-69;715;844;1559
2020-06-05;CyL;60-69;4243;5170;9413
2020-06-05;BU;70-79;393;368;761
2020-06-05;SA;70-79;465;521;986
2020-06-05;SO;70-79;157;136;293
2020-06-05;VA;70-79;532;584;1116
2020-06-05;CyL;70-79;3082;3088;6170
2020-06-05;SO;>80;354;626;980
2020-06-05;ZA;>80;214;334;548
2020-06-05;BU;0-9;221;166;387
2020-06-05;LE;0-9;242;228;470
2020-06-05;SE;0-9;129;112;241
2020-06-05;SO;0-9;61;51;112
2020-06-05;VA;0-9;432;369;801
2020-06-05;AV;20-29;160;209;369
2020-06-05;PA;20-29;141;168;309
2020-06-05;SA;20-29;368;518;886
2020-06-05;SE;20-29;208;309;517
2020-06-05;VA;20-29;425;633;1058
2020-06-05;ZA;20-29;77;104;181
2020-06-05;CyL;20-29;2188;3046;5234
2020-06-05;AV;30-39;271;379;650
2020-06-05;SA;30-39;582;881;1463
2020-06-05;SE;30-39;318;492;810
2020-06-05;LE;40-49;778;1230;2008
2020-06-05;SA;40-49;796;1158;1954
2020-06-05;SO;40-49;258;445;703
2020-06-05;VA;50-59;861;1359;2220
2020-06-05;CyL;50-59;5315;8221;13536
2020-06-05;LE;60-69;685;862;1547
2020-06-05;PA;60-69;261;297;558
2020-06-05;SE;60-69;546;619;1165
2020-06-05;VA;60-69;685;905;1590
2020-06-05;ZA;60-69;212;246;458
2020-06-05;AV;70-79;256;266;522
2020-06-05;PA;70-79;180;194;374
2020-06-05;SE;70-79;370;350;720
2020-06-05;ZA;70-79;144;142;286
2020-06-05;AV;>80;387;605;992
2020-06-05;PA;>80;213;404;617
2020-06-05;SE;>80;577;912;1489
2020-06-05;VA;>80;632;1282;1914
2020-06-05;CyL;>80;4366;7707;12073
2020-06-04;AV;10-19;108;81;189
2020-06-04;BU;10-19;190;192;382
2020-06-04;PA;10-19;78;59;137
2020-06-04;SA;10-19;193;199;392
2020-06-04;VA;10-19;268;280;548
2020-06-04;LE;20-29;316;429;745
2020-06-04;PA;20-29;141;167;308
2020-06-04;SA;20-29;367;516;883
2020-06-04;ZA;20-29;77;104;181
2020-06-04;LE;30-39;525;853;1378
2020-06-04;PA;30-39;234;306;540
2020-06-04;SO;30-39;171;291;462
2020-06-04;VA;30-39;720;1070;1790
2020-06-04;ZA;30-39;125;207;332
2020-06-04;CyL;30-39;3564;5293;8857
2020-06-04;BU;40-49;916;1196;2112
2020-06-04;SA;40-49;793;1158;1951
2020-06-04;VA;40-49;1027;1508;2535
2020-06-04;BU;50-59;814;1177;1991
2020-06-04;LE;50-59;787;1186;1973
2020-06-04;SA;50-59;903;1407;2310
2020-06-04;SE;50-59;672;1090;1762
2020-06-04;VA;50-59;858;1353;2211
2020-06-04;CyL;50-59;5291;8186;13477
2020-06-04;SE;60-69;544;614;1158
2020-06-04;BU;70-79;391;366;757
2020-06-04;SE;70-79;366;348;714
2020-06-04;CyL;70-79;3072;3074;6146
2020-06-04;SA;>80;720;1271;1991
2020-06-04;VA;>80;630;1277;1907
2020-06-04;ZA;>80;214;333;547
2020-06-04;PA;0-9;66;35;101
2020-06-04;SA;0-9;275;299;574
2020-06-04;SE;0-9;129;112;241
2020-06-04;ZA;0-9;197;183;380
2020-06-04;SO;10-19;53;41;94
2020-06-04;CyL;10-19;1222;1206;2428
2020-06-04;AV;20-29;158;207;365
2020-06-04;BU;20-29;373;492;865
2020-06-04;VA;20-29;427;629;1056
2020-06-04;AV;30-39;270;377;647
2020-06-04;BU;30-39;621;821;1442
2020-06-04;SA;30-39;581;877;1458
2020-06-04;AV;40-49;399;561;960
2020-06-04;LE;40-49;769;1225;1994
2020-06-04;SE;40-49;533;797;1330
2020-06-04;ZA;40-49;209;316;525
2020-06-04;AV;50-59;379;636;1015
2020-06-04;SO;50-59;324;527;851
2020-06-04;PA;60-69;262;296;558
2020-06-04;SA;60-69;712;841;1553
2020-06-04;SO;60-69;234;304;538
2020-06-04;CyL;60-69;4229;5153;9382
2020-06-04;AV;70-79;256;266;522
2020-06-04;SA;70-79;464;514;978
2020-06-04;ZA;70-79;144;142;286
2020-06-04;PA;>80;213;402;615
2020-06-04;CyL;>80;4360;7690;12050
2020-06-04;AV;0-9;122;99;221
2020-06-04;BU;0-9;225;166;391
2020-06-04;LE;0-9;241;228;469
2020-06-04;SO;0-9;60;49;109
2020-06-04;VA;0-9;427;364;791
2020-06-04;CyL;0-9;1742;1535;3277
2020-06-04;LE;10-19;164;184;348
2020-06-04;SE;10-19;96;91;187
2020-06-04;ZA;10-19;72;79;151
2020-06-04;SE;20-29;209;311;520
2020-06-04;SO;20-29;116;176;292
2020-06-04;CyL;20-29;2184;3031;5215
2020-06-04;SE;30-39;317;491;808
2020-06-04;PA;40-49;340;418;758
2020-06-04;SO;40-49;257;443;700
2020-06-04;CyL;40-49;5243;7622;12865
2020-06-04;PA;50-59;328;450;778
2020-06-04;ZA;50-59;226;360;586
2020-06-04;AV;60-69;345;411;756
2020-06-04;BU;60-69;557;681;1238
2020-06-04;LE;60-69;682;859;1541
2020-06-04;VA;60-69;681;901;1582
2020-06-04;ZA;60-69;212;246;458
2020-06-04;LE;70-79;583;524;1107
2020-06-04;PA;70-79;180;194;374
2020-06-04;SO;70-79;156;136;292
2020-06-04;VA;70-79;532;584;1116
2020-06-04;AV;>80;387;605;992
2020-06-04;BU;>80;541;957;1498
2020-06-04;LE;>80;724;1308;2032
2020-06-04;SE;>80;577;911;1488
2020-06-04;SO;>80;354;626;980
2020-06-03;LE;0-9;242;229;471
2020-06-03;SE;0-9;129;113;242
2020-06-03;SO;0-9;60;48;108
2020-06-03;SA;10-19;192;196;388
2020-06-03;SE;10-19;96;90;186
2020-06-03;SO;10-19;51;41;92
2020-06-03;CyL;10-19;1216;1189;2405
2020-06-03;AV;20-29;158;208;366
2020-06-03;SA;20-29;361;513;874
2020-06-03;CyL;20-29;2165;3007;5172
2020-06-03;BU;30-39;616;819;1435
2020-06-03;LE;30-39;518;849;1367
2020-06-03;SO;30-39;169;287;456
2020-06-03;SE;40-49;531;794;1325
2020-06-03;ZA;40-49;209;316;525
2020-06-03;CyL;40-49;5222;7590;12812
2020-06-03;PA;60-69;259;288;547
2020-06-03;SA;60-69;710;839;1549
2020-06-03;SO;60-69;231;303;534
2020-06-03;PA;70-79;180;192;372
2020-06-03;SA;70-79;461;509;970
2020-06-03;VA;70-79;530;581;1111
2020-06-03;CyL;70-79;3056;3055;6111
2020-06-03;SE;>80;576;907;1483
2020-06-03;VA;>80;625;1274;1899
2020-06-03;CyL;>80;4352;7674;12026
2020-06-03;AV;0-9;120;100;220
2020-06-03;BU;0-9;223;168;391
2020-06-03;AV;10-19;108;80;188
2020-06-03;BU;10-19;189;192;381
2020-06-03;LE;10-19;165;181;346
2020-06-03;PA;20-29;141;162;303
2020-06-03;SE;20-29;207;309;516
2020-06-03;SO;20-29;115;169;284
2020-06-03;ZA;20-29;76;103;179
2020-06-03;PA;30-39;233;305;538
2020-06-03;SA;30-39;578;875;1453
2020-06-03;SE;30-39;315;488;803
2020-06-03;CyL;30-39;3539;5270;8809
2020-06-03;PA;40-49;340;417;757
2020-06-03;SA;40-49;790;1156;1946
2020-06-03;SO;40-49;255;440;695
2020-06-03;VA;40-49;1022;1496;2518
2020-06-03;AV;50-59;378;634;1012
2020-06-03;SA;50-59;897;1403;2300
2020-06-03;SE;50-59;673;1089;1762
2020-06-03;SO;50-59;324;524;848
2020-06-03;VA;50-59;854;1346;2200
2020-06-03;CyL;50-59;5269;8155;13424
2020-06-03;BU;60-69;550;678;1228
2020-06-03;LE;60-69;675;850;1525
2020-06-03;VA;60-69;680;895;1575
2020-06-03;ZA;60-69;212;246;458
2020-06-03;AV;70-79;254;265;519
2020-06-03;BU;70-79;389;366;755
2020-06-03;SO;70-79;156;135;291
2020-06-03;ZA;70-79;143;142;285
2020-06-03;AV;>80;387;603;990
2020-06-03;LE;>80;724;1304;2028
2020-06-03;SA;>80;719;1268;1987
2020-06-03;SO;>80;353;625;978
2020-06-03;ZA;>80;215;333;548
2020-06-03;PA;0-9;66;36;102
2020-06-03;SA;0-9;274;298;572
2020-06-03;VA;0-9;426;364;790
2020-06-03;ZA;0-9;197;183;380
2020-06-03;CyL;0-9;1737;1539;3276
2020-06-03;PA;10-19;78;57;135
2020-06-03;VA;10-19;265;277;542
2020-06-03;ZA;10-19;72;75;147
2020-06-03;BU;20-29;369;492;861
2020-06-03;LE;20-29;314;425;739
2020-06-03;VA;20-29;424;626;1050
2020-06-03;AV;30-39;270;375;645
2020-06-03;VA;30-39;715;1066;1781
2020-06-03;ZA;30-39;125;206;331
2020-06-03;AV;40-49;395;561;956
2020-06-03;BU;40-49;914;1192;2106
2020-06-03;LE;40-49;766;1218;1984
2020-06-03;BU;50-59;809;1175;1984
2020-06-03;LE;50-59;781;1178;1959
2020-06-03;PA;50-59;328;448;776
2020-06-03;ZA;50-59;225;358;583
2020-06-03;AV;60-69;340;408;748
2020-06-03;SE;60-69;541;610;1151
2020-06-03;CyL;60-69;4198;5117;9315
2020-06-03;LE;70-79;580;518;1098
2020-06-03;SE;70-79;363;347;710
2020-06-03;BU;>80;540;958;1498
2020-06-03;PA;>80;213;402;615
2020-06-02;LE;0-9;246;231;477
2020-06-02;PA;0-9;65;36;101
2020-06-02;SA;0-9;273;298;571
2020-06-02;SE;0-9;128;112;240
2020-06-02;AV;10-19;107;80;187
2020-06-02;BU;10-19;188;192;380
2020-06-02;PA;10-19;79;57;136
2020-06-02;SE;10-19;94;90;184
2020-06-02;PA;20-29;142;161;303
2020-06-02;SA;20-29;358;513;871
2020-06-02;SO;20-29;110;167;277
2020-06-02;AV;30-39;269;373;642
2020-06-02;BU;30-39;615;817;1432
2020-06-02;LE;30-39;514;842;1356
2020-06-02;PA;30-39;234;307;541
2020-06-02;CyL;30-39;3519;5254;8773
2020-06-02;LE;40-49;761;1216;1977
2020-06-02;PA;40-49;343;413;756
2020-06-02;AV;50-59;378;632;1010
2020-06-02;SA;50-59;893;1401;2294
2020-06-02;SE;50-59;672;1083;1755
2020-06-02;SO;50-59;323;523;846
2020-06-02;VA;50-59;846;1341;2187
2020-06-02;AV;60-69;340;406;746
2020-06-02;BU;60-69;544;674;1218
2020-06-02;VA;60-69;676;890;1566
2020-06-02;SO;70-79;156;135;291
2020-06-02;ZA;70-79;143;141;284
2020-06-02;AV;>80;387;598;985
2020-06-02;BU;>80;537;952;1489
2020-06-02;LE;>80;722;1300;2022
2020-06-02;SA;>80;716;1266;1982
2020-06-02;ZA;>80;214;333;547
2020-06-02;BU;0-9;224;165;389
2020-06-02;CyL;0-9;1734;1537;3271
2020-06-02;LE;10-19;166;181;347
2020-06-02;SO;10-19;51;41;92
2020-06-02;ZA;10-19;72;75;147
2020-06-02;CyL;10-19;1205;1180;2385
2020-06-02;AV;20-29;157;208;365
2020-06-02;BU;20-29;366;491;857
2020-06-02;SE;20-29;206;309;515
2020-06-02;CyL;20-29;2144;2994;5138
2020-06-02;SA;30-39;575;872;1447
2020-06-02;SE;30-39;313;486;799
2020-06-02;SO;30-39;170;286;456
2020-06-02;VA;30-39;705;1064;1769
2020-06-02;BU;40-49;908;1189;2097
2020-06-02;SA;40-49;790;1152;1942
2020-06-02;SE;40-49;529;795;1324
2020-06-02;SO;40-49;254;438;692
2020-06-02;VA;40-49;1012;1489;2501
2020-06-02;ZA;40-49;209;313;522
2020-06-02;LE;50-59;778;1173;1951
2020-06-02;PA;50-59;327;448;775
2020-06-02;CyL;50-59;5245;8127;13372
2020-06-02;PA;60-69;257;287;544
2020-06-02;SA;60-69;709;830;1539
2020-06-02;SO;60-69;230;302;532
2020-06-02;ZA;60-69;211;246;457
2020-06-02;CyL;60-69;4175;5086;9261
2020-06-02;AV;70-79;253;263;516
2020-06-02;BU;70-79;389;364;753
2020-06-02;LE;70-79;578;515;1093
2020-06-02;PA;70-79;178;191;369
2020-06-02;SE;70-79;362;347;709
2020-06-02;VA;70-79;529;580;1109
2020-06-02;CyL;70-79;3048;3042;6090
2020-06-02;SE;>80;575;906;1481
2020-06-02;SO;>80;352;624;976
2020-06-02;VA;>80;625;1273;1898
2020-06-02;CyL;>80;4341;7656;11997
2020-06-02;AV;0-9;120;99;219
2020-06-02;SO;0-9;60;49;109
2020-06-02;VA;0-9;422;363;785
2020-06-02;ZA;0-9;196;184;380
2020-06-02;SA;10-19;187;192;379
2020-06-02;VA;10-19;261;272;533
2020-06-02;LE;20-29;309;419;728
2020-06-02;VA;20-29;422;624;1046
2020-06-02;ZA;20-29;74;102;176
2020-06-02;ZA;30-39;124;207;331
2020-06-02;AV;40-49;394;561;955
2020-06-02;CyL;40-49;5200;7566;12766
2020-06-02;BU;50-59;806;1169;1975
2020-06-02;ZA;50-59;222;357;579
2020-06-02;LE;60-69;668;844;1512
2020-06-02;SE;60-69;540;607;1147
2020-06-02;SA;70-79;460;506;966
2020-06-02;PA;>80;213;404;617
2020-06-01;AV;0-9;121;98;219
2020-06-01;PA;0-9;65;36;101
2020-06-01;VA;0-9;417;357;774
2020-06-01;LE;10-19;164;182;346
2020-06-01;AV;20-29;153;208;361
2020-06-01;BU;20-29;366;485;851
2020-06-01;LE;20-29;303;416;719
2020-06-01;ZA;20-29;72;98;170
2020-06-01;PA;30-39;234;304;538
2020-06-01;SO;30-39;168;284;452
2020-06-01;VA;30-39;699;1059;1758
2020-06-01;AV;40-49;392;561;953
2020-06-01;SE;40-49;528;793;1321
2020-06-01;SO;40-49;253;436;689
2020-06-01;VA;40-49;1009;1477;2486
2020-06-01;CyL;40-49;5183;7526;12709
2020-06-01;BU;50-59;806;1166;1972
2020-06-01;PA;50-59;323;448;771
2020-06-01;SA;50-59;892;1395;2287
2020-06-01;VA;50-59;840;1336;2176
2020-06-01;AV;60-69;333;400;733
2020-06-01;LE;60-69;664;836;1500
2020-06-01;ZA;60-69;211;245;456
2020-06-01;CyL;60-69;4149;5052;9201
2020-06-01;BU;70-79;387;362;749
2020-06-01;LE;70-79;577;510;1087
2020-06-01;SA;70-79;457;504;961
2020-06-01;ZA;70-79;143;141;284
2020-06-01;CyL;70-79;3030;3018;6048
2020-06-01;BU;>80;535;940;1475
2020-06-01;LE;>80;719;1296;2015
2020-06-01;PA;>80;212;402;614
2020-06-01;SO;>80;352;624;976
2020-06-01;LE;0-9;244;228;472
2020-06-01;SE;0-9;125;110;235
2020-06-01;SO;0-9;61;48;109
2020-06-01;AV;10-19;105;79;184
2020-06-01;PA;10-19;77;55;132
2020-06-01;SA;10-19;184;188;372
2020-06-01;VA;10-19;258;269;527
2020-06-01;PA;20-29;142;160;302
2020-06-01;SA;20-29;354;510;864
2020-06-01;VA;20-29;414;620;1034
2020-06-01;CyL;20-29;2119;2968;5087
2020-06-01;BU;30-39;610;810;1420
2020-06-01;ZA;30-39;123;205;328
2020-06-01;AV;50-59;377;630;1007
2020-06-01;LE;50-59;772;1161;1933
2020-06-01;ZA;50-59;219;355;574
2020-06-01;SA;60-69;707;827;1534
2020-06-01;SO;60-69;229;300;529
2020-06-01;VA;60-69;672;882;1554
2020-06-01;SE;70-79;360;343;703
2020-06-01;SO;70-79;155;133;288
2020-06-01;VA;70-79;525;575;1100
2020-06-01;SA;>80;715;1266;1981
2020-06-01;SE;>80;574;903;1477
2020-06-01;VA;>80;621;1270;1891
2020-06-01;ZA;>80;214;332;546
2020-06-01;CyL;>80;4329;7623;11952
2020-06-01;BU;0-9;218;163;381
2020-06-01;SA;0-9;270;298;568
2020-06-01;ZA;0-9;195;183;378
2020-06-01;CyL;0-9;1716;1521;3237
2020-06-01;BU;10-19;188;191;379
2020-06-01;SE;10-19;92;88;180
2020-06-01;SO;10-19;51;41;92
2020-06-01;ZA;10-19;71;75;146
2020-06-01;CyL;10-19;1190;1168;2358
2020-06-01;SE;20-29;206;305;511
2020-06-01;SO;20-29;109;166;275
2020-06-01;AV;30-39;269;370;639
2020-06-01;LE;30-39;514;835;1349
2020-06-01;SA;30-39;571;865;1436
2020-06-01;SE;30-39;308;485;793
2020-06-01;CyL;30-39;3496;5217;8713
2020-06-01;BU;40-49;906;1188;2094
2020-06-01;LE;40-49;757;1204;1961
2020-06-01;PA;40-49;344;408;752
2020-06-01;SA;40-49;786;1147;1933
2020-06-01;ZA;40-49;208;312;520
2020-06-01;SE;50-59;666;1076;1742
2020-06-01;SO;50-59;322;523;845
2020-06-01;CyL;50-59;5217;8090;13307
2020-06-01;BU;60-69;541;673;1214
2020-06-01;PA;60-69;257;287;544
2020-06-01;SE;60-69;535;602;1137
2020-06-01;AV;70-79;249;260;509
2020-06-01;PA;70-79;177;190;367
2020-06-01;AV;>80;387;590;977
2020-05-31;BU;0-9;216;162;378
2020-05-31;PA;0-9;65;35;100
2020-05-31;SA;0-9;267;297;564
2020-05-31;VA;0-9;414;357;771
2020-05-31;CyL;0-9;1703;1516;3219
2020-05-31;BU;10-19;183;188;371
2020-05-31;SO;10-19;50;41;91
2020-05-31;CyL;20-29;2105;2949;5054
2020-05-31;ZA;30-39;123;204;327
2020-05-31;AV;40-49;393;560;953
2020-05-31;BU;40-49;903;1185;2088
2020-05-31;PA;40-49;341;404;745
2020-05-31;SA;40-49;783;1145;1928
2020-05-31;VA;40-49;1003;1470;2473
2020-05-31;SO;50-59;323;522;845
2020-05-31;CyL;50-59;5194;8056;13250
2020-05-31;LE;60-69;664;828;1492
2020-05-31;SA;60-69;703;822;1525
2020-05-31;AV;70-79;250;259;509
2020-05-31;BU;70-79;386;362;748
2020-05-31;SE;70-79;361;339;700
2020-05-31;VA;70-79;523;573;1096
2020-05-31;ZA;70-79;143;140;283
2020-05-31;CyL;70-79;3019;3004;6023
2020-05-31;SE;>80;573;903;1476
2020-05-31;SO;0-9;60;48;108
2020-05-31;LE;10-19;162;176;338
2020-05-31;PA;10-19;77;55;132
2020-05-31;SA;10-19;181;187;368
2020-05-31;SE;10-19;88;85;173
2020-05-31;VA;10-19;257;268;525
2020-05-31;AV;20-29;153;207;360
2020-05-31;BU;20-29;364;481;845
2020-05-31;PA;20-29;141;157;298
2020-05-31;SE;20-29;203;301;504
2020-05-31;PA;30-39;232;304;536
2020-05-31;SA;30-39;567;863;1430
2020-05-31;SO;30-39;167;284;451
2020-05-31;SO;40-49;253;437;690
2020-05-31;PA;50-59;320;447;767
2020-05-31;SE;50-59;664;1071;1735
2020-05-31;VA;50-59;832;1327;2159
2020-05-31;AV;60-69;332;401;733
2020-05-31;BU;60-69;541;673;1214
2020-05-31;SE;60-69;533;599;1132
2020-05-31;SO;60-69;227;297;524
2020-05-31;CyL;60-69;4130;5019;9149
2020-05-31;SO;70-79;154;132;286
2020-05-31;AV;>80;388;591;979
2020-05-31;BU;>80;533;941;1474
2020-05-31;VA;>80;618;1257;1875
2020-05-31;ZA;>80;214;332;546
2020-05-31;CyL;>80;4322;7605;11927
2020-05-31;AV;0-9;121;100;221
2020-05-31;LE;0-9;243;227;470
2020-05-31;SE;0-9;123;108;231
2020-05-31;ZA;0-9;194;182;376
2020-05-31;AV;10-19;107;78;185
2020-05-31;ZA;10-19;71;75;146
2020-05-31;CyL;10-19;1176;1153;2329
2020-05-31;LE;20-29;299;415;714
2020-05-31;SA;20-29;351;510;861
2020-05-31;SO;20-29;110;166;276
2020-05-31;VA;20-29;412;614;1026
2020-05-31;ZA;20-29;72;98;170
2020-05-31;AV;30-39;269;370;639
2020-05-31;BU;30-39;602;810;1412
2020-05-31;LE;30-39;511;833;1344
2020-05-31;SE;30-39;306;482;788
2020-05-31;VA;30-39;695;1047;1742
2020-05-31;CyL;30-39;3472;5197;8669
2020-05-31;LE;40-49;756;1198;1954
2020-05-31;SE;40-49;525;788;1313
2020-05-31;ZA;40-49;208;312;520
2020-05-31;CyL;40-49;5165;7499;12664
2020-05-31;AV;50-59;377;625;1002
2020-05-31;BU;50-59;804;1163;1967
2020-05-31;LE;50-59;767;1154;1921
2020-05-31;SA;50-59;888;1393;2281
2020-05-31;ZA;50-59;219;354;573
2020-05-31;PA;60-69;255;284;539
2020-05-31;VA;60-69;665;871;1536
2020-05-31;ZA;60-69;210;244;454
2020-05-31;LE;70-79;572;508;1080
2020-05-31;PA;70-79;177;189;366
2020-05-31;SA;70-79;453;502;955
2020-05-31;LE;>80;719;1292;2011
2020-05-31;PA;>80;212;403;615
2020-05-31;SA;>80;714;1264;1978
2020-05-31;SO;>80;351;622;973
2020-05-30;SO;0-9;60;48;108
2020-05-30;CyL;0-9;1702;1514;3216
2020-05-30;AV;10-19;107;78;185
2020-05-30;PA;10-19;77;55;132
2020-05-30;ZA;10-19;71;75;146
2020-05-30;AV;20-29;153;206;359
2020-05-30;LE;30-39;511;833;1344
2020-05-30;PA;30-39;232;304;536
2020-05-30;CyL;30-39;3469;5193;8662
2020-05-30;LE;40-49;755;1197;1952
2020-05-30;SA;40-49;784;1145;1929
2020-05-30;VA;40-49;1003;1468;2471
2020-05-30;ZA;40-49;208;312;520
2020-05-30;CyL;40-49;5163;7492;12655
2020-05-30;BU;50-59;802;1163;1965
2020-05-30;SA;50-59;888;1393;2281
2020-05-30;VA;50-59;831;1326;2157
2020-05-30;ZA;50-59;219;354;573
2020-05-30;AV;60-69;332;399;731
2020-05-30;BU;60-69;540;673;1213
2020-05-30;VA;60-69;663;870;1533
2020-05-30;ZA;60-69;209;244;453
2020-05-30;CyL;60-69;4121;5013;9134
2020-05-30;AV;70-79;250;259;509
2020-05-30;SE;70-79;360;339;699
2020-05-30;SO;70-79;154;132;286
2020-05-30;PA;>80;211;402;613
2020-05-30;SA;>80;714;1262;1976
2020-05-30;ZA;>80;214;332;546
2020-05-30;CyL;>80;4316;7595;11911
2020-05-30;AV;0-9;121;100;221
2020-05-30;LE;0-9;243;226;469
2020-05-30;PA;0-9;64;34;98
2020-05-30;SA;0-9;267;297;564
2020-05-30;SE;0-9;123;108;231
2020-05-30;VA;0-9;414;357;771
2020-05-30;ZA;0-9;194;182;376
2020-05-30;BU;10-19;183;188;371
2020-05-30;SE;10-19;87;85;172
2020-05-30;BU;20-29;364;481;845
2020-05-30;LE;20-29;297;415;712
2020-05-30;PA;20-29;139;157;296
2020-05-30;SA;20-29;350;510;860
2020-05-30;SO;20-29;109;166;275
2020-05-30;VA;20-29;411;614;1025
2020-05-30;ZA;20-29;72;98;170
2020-05-30;CyL;20-29;2098;2947;5045
2020-05-30;BU;30-39;602;810;1412
2020-05-30;SA;30-39;567;863;1430
2020-05-30;SE;30-39;304;481;785
2020-05-30;SO;40-49;252;434;686
2020-05-30;AV;50-59;376;624;1000
2020-05-30;LE;50-59;767;1153;1920
2020-05-30;PA;50-59;319;447;766
2020-05-30;SO;50-59;320;520;840
2020-05-30;LE;60-69;664;828;1492
2020-05-30;PA;60-69;253;284;537
2020-05-30;SO;60-69;225;295;520
2020-05-30;LE;70-79;572;508;1080
2020-05-30;SA;70-79;453;502;955
2020-05-30;AV;>80;386;588;974
2020-05-30;BU;0-9;216;162;378
2020-05-30;LE;10-19;162;175;337
2020-05-30;SA;10-19;181;187;368
2020-05-30;SO;10-19;51;41;92
2020-05-30;VA;10-19;257;268;525
2020-05-30;CyL;10-19;1176;1152;2328
2020-05-30;SE;20-29;203;300;503
2020-05-30;AV;30-39;269;369;638
2020-05-30;SO;30-39;166;283;449
2020-05-30;VA;30-39;695;1046;1741
2020-05-30;ZA;30-39;123;204;327
2020-05-30;AV;40-49;393;560;953
2020-05-30;BU;40-49;903;1184;2087
2020-05-30;PA;40-49;341;404;745
2020-05-30;SE;40-49;524;788;1312
2020-05-30;SE;50-59;663;1069;1732
2020-05-30;CyL;50-59;5185;8049;13234
2020-05-30;SA;60-69;703;821;1524
2020-05-30;SE;60-69;532;599;1131
2020-05-30;BU;70-79;385;362;747
2020-05-30;PA;70-79;175;189;364
2020-05-30;VA;70-79;523;573;1096
2020-05-30;ZA;70-79;143;140;283
2020-05-30;CyL;70-79;3015;3004;6019
2020-05-30;BU;>80;531;939;1470
2020-05-30;LE;>80;719;1290;2009
2020-05-30;SE;>80;572;903;1475
2020-05-30;SO;>80;351;622;973
2020-05-30;VA;>80;618;1257;1875
2020-05-29;BU;0-9;211;156;367
2020-05-29;PA;0-9;63;30;93
2020-05-29;LE;10-19;161;172;333
2020-05-29;SA;10-19;179;183;362
2020-05-29;ZA;10-19;70;73;143
2020-05-29;PA;20-29;136;150;286
2020-05-29;SO;20-29;108;163;271
2020-05-29;AV;30-39;259;346;605
2020-05-29;PA;30-39;218;291;509
2020-05-29;AV;40-49;380;538;918
2020-05-29;SO;40-49;247;430;677
2020-05-29;ZA;40-49;204;299;503
2020-05-29;LE;50-59;748;1096;1844
2020-05-29;PA;50-59;311;437;748
2020-05-29;VA;50-59;804;1295;2099
2020-05-29;ZA;50-59;214;350;564
2020-05-29;BU;60-69;522;657;1179
2020-05-29;VA;60-69;656;845;1501
2020-05-29;ZA;60-69;205;236;441
2020-05-29;SA;70-79;449;491;940
2020-05-29;LE;>80;702;1255;1957
2020-05-29;AV;0-9;117;98;215
2020-05-29;LE;0-9;238;216;454
2020-05-29;SE;0-9;122;105;227
2020-05-29;SO;0-9;59;48;107
2020-05-29;VA;0-9;400;349;749
2020-05-29;CyL;0-9;1654;1469;3123
2020-05-29;BU;10-19;180;184;364
2020-05-29;CyL;10-19;1143;1122;2265
2020-05-29;BU;20-29;351;454;805
2020-05-29;LE;20-29;281;397;678
2020-05-29;CyL;20-29;2026;2844;4870
2020-05-29;LE;30-39;491;780;1271
2020-05-29;SE;30-39;291;465;756
2020-05-29;SO;30-39;161;279;440
2020-05-29;ZA;30-39;122;197;319
2020-05-29;BU;40-49;876;1134;2010
2020-05-29;LE;40-49;723;1136;1859
2020-05-29;PA;40-49;329;381;710
2020-05-29;SA;40-49;757;1114;1871
2020-05-29;SE;40-49;502;761;1263
2020-05-29;VA;40-49;982;1420;2402
2020-05-29;CyL;40-49;5000;7213;12213
2020-05-29;AV;50-59;363;606;969
2020-05-29;BU;50-59;780;1126;1906
2020-05-29;SE;50-59;646;1054;1700
2020-05-29;CyL;50-59;5056;7837;12893
2020-05-29;AV;60-69;327;388;715
2020-05-29;LE;60-69;642;794;1436
2020-05-29;SE;60-69;520;582;1102
2020-05-29;SO;60-69;222;285;507
2020-05-29;LE;70-79;557;492;1049
2020-05-29;SE;70-79;354;330;684
2020-05-29;SO;70-79;153;130;283
2020-05-29;VA;70-79;519;559;1078
2020-05-29;PA;>80;205;389;594
2020-05-29;VA;>80;609;1239;1848
2020-05-29;CyL;>80;4246;7455;11701
2020-05-29;SA;0-9;256;289;545
2020-05-29;ZA;0-9;188;178;366
2020-05-29;AV;10-19;102;77;179
2020-05-29;PA;10-19;72;54;126
2020-05-29;SE;10-19;85;82;167
2020-05-29;SO;10-19;48;38;86
2020-05-29;VA;10-19;246;259;505
2020-05-29;AV;20-29;149;201;350
2020-05-29;SA;20-29;344;500;844
2020-05-29;SE;20-29;195;290;485
2020-05-29;VA;20-29;390;592;982
2020-05-29;ZA;20-29;72;97;169
2020-05-29;BU;30-39;583;776;1359
2020-05-29;SA;30-39;556;845;1401
2020-05-29;VA;30-39;669;1002;1671
2020-05-29;CyL;30-39;3350;4981;8331
2020-05-29;SA;50-59;874;1360;2234
2020-05-29;SO;50-59;316;513;829
2020-05-29;PA;60-69;246;273;519
2020-05-29;SA;60-69;690;797;1487
2020-05-29;CyL;60-69;4030;4857;8887
2020-05-29;AV;70-79;246;257;503
2020-05-29;BU;70-79;380;355;735
2020-05-29;PA;70-79;172;184;356
2020-05-29;ZA;70-79;139;139;278
2020-05-29;CyL;70-79;2969;2937;5906
2020-05-29;AV;>80;380;580;960
2020-05-29;BU;>80;525;921;1446
2020-05-29;SA;>80;706;1239;1945
2020-05-29;SE;>80;560;892;1452
2020-05-29;SO;>80;346;617;963
2020-05-29;ZA;>80;213;323;536
2020-05-28;SO;0-9;58;47;105
2020-05-28;VA;0-9;400;346;746
2020-05-28;BU;10-19;174;179;353
2020-05-28;PA;10-19;72;54;126
2020-05-28;SE;10-19;83;80;163
2020-05-28;VA;10-19;243;248;491
2020-05-28;PA;20-29;133;147;280
2020-05-28;LE;30-39;487;774;1261
2020-05-28;ZA;30-39;123;195;318
2020-05-28;BU;40-49;873;1126;1999
2020-05-28;SO;40-49;242;417;659
2020-05-28;VA;40-49;977;1404;2381
2020-05-28;CyL;40-49;4957;7132;12089
2020-05-28;BU;50-59;770;1114;1884
2020-05-28;SA;50-59;859;1348;2207
2020-05-28;ZA;50-59;210;341;551
2020-05-28;LE;60-69;633;775;1408
2020-05-28;SO;60-69;218;279;497
2020-05-28;VA;60-69;651;839;1490
2020-05-28;ZA;60-69;203;232;435
2020-05-28;CyL;60-69;3991;4793;8784
2020-05-28;ZA;70-79;138;135;273
2020-05-28;BU;>80;521;914;1435
2020-05-28;SE;>80;558;884;1442
2020-05-28;LE;0-9;230;211;441
2020-05-28;PA;0-9;62;30;92
2020-05-28;ZA;0-9;182;180;362
2020-05-28;AV;10-19;101;75;176
2020-05-28;LE;10-19;156;168;324
2020-05-28;CyL;10-19;1116;1095;2211
2020-05-28;AV;20-29;147;198;345
2020-05-28;BU;20-29;349;446;795
2020-05-28;LE;20-29;276;385;661
2020-05-28;SA;20-29;336;497;833
2020-05-28;VA;20-29;386;591;977
2020-05-28;CyL;20-29;1997;2812;4809
2020-05-28;AV;30-39;256;346;602
2020-05-28;CyL;30-39;3318;4945;8263
2020-05-28;AV;40-49;377;537;914
2020-05-28;AV;50-59;360;596;956
2020-05-28;LE;50-59;738;1091;1829
2020-05-28;PA;50-59;304;437;741
2020-05-28;SE;50-59;636;1049;1685
2020-05-28;CyL;50-59;4986;7763;12749
2020-05-28;AV;60-69;321;387;708
2020-05-28;BU;60-69;518;650;1168
2020-05-28;PA;60-69;246;271;517
2020-05-28;SE;60-69;515;574;1089
2020-05-28;LE;70-79;553;488;1041
2020-05-28;SE;70-79;349;320;669
2020-05-28;VA;70-79;515;552;1067
2020-05-28;CyL;70-79;2949;2904;5853
2020-05-28;AV;>80;379;579;958
2020-05-28;LE;>80;694;1249;1943
2020-05-28;PA;>80;204;387;591
2020-05-28;SA;>80;703;1225;1928
2020-05-28;AV;0-9;117;95;212
2020-05-28;BU;0-9;209;153;362
2020-05-28;SA;0-9;257;290;547
2020-05-28;SE;0-9;119;102;221
2020-05-28;CyL;0-9;1634;1454;3088
2020-05-28;SA;10-19;175;182;357
2020-05-28;SO;10-19;43;37;80
2020-05-28;ZA;10-19;69;72;141
2020-05-28;SE;20-29;192;290;482
2020-05-28;SO;20-29;107;161;268
2020-05-28;ZA;20-29;71;97;168
2020-05-28;BU;30-39;579;772;1351
2020-05-28;PA;30-39;218;289;507
2020-05-28;SA;30-39;545;842;1387
2020-05-28;SE;30-39;286;458;744
2020-05-28;SO;30-39;163;277;440
2020-05-28;VA;30-39;661;992;1653
2020-05-28;LE;40-49;719;1121;1840
2020-05-28;PA;40-49;323;378;701
2020-05-28;SA;40-49;749;1100;1849
2020-05-28;SE;40-49;494;752;1246
2020-05-28;ZA;40-49;203;297;500
2020-05-28;SO;50-59;311;504;815
2020-05-28;VA;50-59;798;1283;2081
2020-05-28;SA;60-69;686;786;1472
2020-05-28;AV;70-79;244;254;498
2020-05-28;BU;70-79;378;349;727
2020-05-28;PA;70-79;169;184;353
2020-05-28;SA;70-79;449;493;942
2020-05-28;SO;70-79;154;129;283
2020-05-28;SO;>80;346;616;962
2020-05-28;VA;>80;603;1228;1831
2020-05-28;ZA;>80;211;320;531
2020-05-28;CyL;>80;4219;7402;11621
2020-05-27;AV;0-9;117;95;212
2020-05-27;VA;0-9;400;346;746
2020-05-27;VA;10-19;243;248;491
2020-05-27;ZA;10-19;69;72;141
2020-05-27;BU;30-39;579;772;1351
2020-05-27;LE;30-39;487;774;1261
2020-05-27;SE;30-39;286;458;744
2020-05-27;VA;30-39;661;992;1653
2020-05-27;SA;40-49;749;1100;1849
2020-05-27;SE;40-49;494;752;1246
2020-05-27;SO;40-49;242;417;659
2020-05-27;BU;50-59;770;1114;1884
2020-05-27;LE;50-59;738;1091;1829
2020-05-27;SE;50-59;636;1049;1685
2020-05-27;VA;50-59;798;1283;2081
2020-05-27;PA;60-69;246;271;517
2020-05-27;SO;60-69;218;279;497
2020-05-27;CyL;60-69;3991;4793;8784
2020-05-27;BU;70-79;378;349;727
2020-05-27;VA;70-79;515;552;1067
2020-05-27;ZA;70-79;138;135;273
2020-05-27;LE;>80;694;1249;1943
2020-05-27;PA;>80;204;387;591
2020-05-27;SE;>80;558;884;1442
2020-05-27;VA;>80;603;1228;1831
2020-05-27;CyL;>80;4219;7402;11621
2020-05-27;BU;0-9;209;153;362
2020-05-27;LE;0-9;230;211;441
2020-05-27;SO;0-9;58;47;105
2020-05-27;CyL;0-9;1634;1454;3088
2020-05-27;AV;10-19;101;75;176
2020-05-27;LE;10-19;156;168;324
2020-05-27;PA;10-19;72;54;126
2020-05-27;LE;20-29;276;385;661
2020-05-27;PA;20-29;133;147;280
2020-05-27;VA;20-29;386;591;977
2020-05-27;CyL;20-29;1997;2812;4809
2020-05-27;AV;30-39;256;346;602
2020-05-27;PA;30-39;218;289;507
2020-05-27;ZA;30-39;123;195;318
2020-05-27;CyL;30-39;3318;4945;8263
2020-05-27;BU;40-49;873;1126;1999
2020-05-27;LE;40-49;719;1121;1840
2020-05-27;VA;40-49;977;1404;2381
2020-05-27;ZA;40-49;203;297;500
2020-05-27;CyL;40-49;4957;7132;12089
2020-05-27;AV;50-59;360;596;956
2020-05-27;PA;50-59;304;437;741
2020-05-27;SA;50-59;859;1348;2207
2020-05-27;SO;50-59;311;504;815
2020-05-27;SA;60-69;686;786;1472
2020-05-27;VA;60-69;651;839;1490
2020-05-27;LE;70-79;553;488;1041
2020-05-27;SA;70-79;449;493;942
2020-05-27;SE;70-79;349;320;669
2020-05-27;PA;0-9;62;30;92
2020-05-27;SA;0-9;257;290;547
2020-05-27;SE;0-9;119;102;221
2020-05-27;ZA;0-9;182;180;362
2020-05-27;BU;10-19;174;179;353
2020-05-27;SA;10-19;175;182;357
2020-05-27;SE;10-19;83;80;163
2020-05-27;SO;10-19;43;37;80
2020-05-27;CyL;10-19;1116;1095;2211
2020-05-27;AV;20-29;147;198;345
2020-05-27;BU;20-29;349;446;795
2020-05-27;SA;20-29;336;497;833
2020-05-27;SE;20-29;192;290;482
2020-05-27;SO;20-29;107;161;268
2020-05-27;ZA;20-29;71;97;168
2020-05-27;SA;30-39;545;842;1387
2020-05-27;SO;30-39;163;277;440
2020-05-27;AV;40-49;377;537;914
2020-05-27;PA;40-49;323;378;701
2020-05-27;ZA;50-59;210;341;551
2020-05-27;CyL;50-59;4986;7763;12749
2020-05-27;AV;60-69;321;387;708
2020-05-27;BU;60-69;518;650;1168
2020-05-27;LE;60-69;633;775;1408
2020-05-27;SE;60-69;515;574;1089
2020-05-27;ZA;60-69;203;232;435
2020-05-27;AV;70-79;244;254;498
2020-05-27;PA;70-79;169;184;353
2020-05-27;SO;70-79;154;129;283
2020-05-27;CyL;70-79;2949;2904;5853
2020-05-27;AV;>80;379;579;958
2020-05-27;BU;>80;521;914;1435
2020-05-27;SA;>80;703;1225;1928
2020-05-27;SO;>80;346;616;962
2020-05-27;ZA;>80;211;320;531
2020-05-26;LE;0-9;226;205;431
2020-05-26;PA;0-9;62;30;92
2020-05-26;SE;0-9;116;102;218
2020-05-26;AV;10-19;99;74;173
2020-05-26;BU;10-19;171;178;349
2020-05-26;SE;10-19;81;78;159
2020-05-26;ZA;10-19;68;71;139
2020-05-26;BU;20-29;341;446;787
2020-05-26;LE;20-29;275;386;661
2020-05-26;SE;20-29;188;281;469
2020-05-26;LE;30-39;486;765;1251
2020-05-26;SO;30-39;161;277;438
2020-05-26;ZA;30-39;123;194;317
2020-05-26;CyL;30-39;3300;4916;8216
2020-05-26;SE;40-49;488;741;1229
2020-05-26;SE;50-59;624;1029;1653
2020-05-26;SO;50-59;310;495;805
2020-05-26;CyL;50-59;4945;7692;12637
2020-05-26;VA;60-69;647;835;1482
2020-05-26;ZA;60-69;201;231;432
2020-05-26;AV;70-79;241;252;493
2020-05-26;BU;70-79;376;345;721
2020-05-26;LE;70-79;548;485;1033
2020-05-26;SA;70-79;448;488;936
2020-05-26;VA;70-79;514;548;1062
2020-05-26;ZA;70-79;138;134;272
2020-05-26;PA;>80;203;387;590
2020-05-26;SA;>80;701;1226;1927
2020-05-26;SE;>80;553;881;1434
2020-05-26;ZA;>80;211;319;530
2020-05-26;AV;0-9;116;95;211
2020-05-26;BU;0-9;209;152;361
2020-05-26;SA;0-9;258;289;547
2020-05-26;SO;0-9;60;48;108
2020-05-26;VA;0-9;392;345;737
2020-05-26;CyL;0-9;1620;1446;3066
2020-05-26;PA;10-19;76;54;130
2020-05-26;SA;10-19;176;182;358
2020-05-26;VA;10-19;241;244;485
2020-05-26;AV;20-29;145;198;343
2020-05-26;PA;30-39;217;285;502
2020-05-26;SA;30-39;542;838;1380
2020-05-26;SE;30-39;282;451;733
2020-05-26;VA;30-39;658;993;1651
2020-05-26;BU;40-49;869;1119;1988
2020-05-26;LE;40-49;715;1112;1827
2020-05-26;PA;40-49;324;377;701
2020-05-26;ZA;40-49;204;298;502
2020-05-26;CyL;40-49;4932;7092;12024
2020-05-26;PA;50-59;300;434;734
2020-05-26;VA;50-59;788;1277;2065
2020-05-26;ZA;50-59;209;342;551
2020-05-26;AV;60-69;319;384;703
2020-05-26;LE;60-69;628;773;1401
2020-05-26;PA;60-69;241;267;508
2020-05-26;SE;60-69;503;568;1071
2020-05-26;SO;60-69;218;272;490
2020-05-26;PA;70-79;166;178;344
2020-05-26;SE;70-79;346;317;663
2020-05-26;LE;>80;693;1246;1939
2020-05-26;VA;>80;602;1223;1825
2020-05-26;ZA;0-9;181;180;361
2020-05-26;LE;10-19;152;165;317
2020-05-26;SO;10-19;43;36;79
2020-05-26;CyL;10-19;1107;1082;2189
2020-05-26;PA;20-29;134;146;280
2020-05-26;SA;20-29;331;499;830
2020-05-26;SO;20-29;104;159;263
2020-05-26;VA;20-29;389;586;975
2020-05-26;ZA;20-29;70;97;167
2020-05-26;CyL;20-29;1977;2798;4775
2020-05-26;AV;30-39;255;343;598
2020-05-26;BU;30-39;576;770;1346
2020-05-26;AV;40-49;375;534;909
2020-05-26;SA;40-49;740;1098;1838
2020-05-26;SO;40-49;242;411;653
2020-05-26;VA;40-49;975;1402;2377
2020-05-26;AV;50-59;358;589;947
2020-05-26;BU;50-59;764;1106;1870
2020-05-26;LE;50-59;731;1080;1811
2020-05-26;SA;50-59;861;1340;2201
2020-05-26;BU;60-69;514;646;1160
2020-05-26;SA;60-69;680;783;1463
2020-05-26;CyL;60-69;3951;4759;8710
2020-05-26;SO;70-79;154;127;281
2020-05-26;CyL;70-79;2931;2874;5805
2020-05-26;AV;>80;375;579;954
2020-05-26;BU;>80;520;909;1429
2020-05-26;SO;>80;344;616;960
2020-05-26;CyL;>80;4202;7386;11588
2020-05-25;BU;0-9;201;154;355
2020-05-25;LE;0-9;226;205;431
2020-05-25;VA;0-9;385;343;728
2020-05-25;ZA;0-9;181;179;360
2020-05-25;AV;10-19;97;75;172
2020-05-25;PA;10-19;74;53;127
2020-05-25;SE;10-19;81;78;159
2020-05-25;SO;10-19;42;36;78
2020-05-25;VA;10-19;239;243;482
2020-05-25;SO;20-29;103;158;261
2020-05-25;VA;20-29;383;575;958
2020-05-25;AV;30-39;253;341;594
2020-05-25;SE;30-39;280;440;720
2020-05-25;BU;40-49;863;1105;1968
2020-05-25;SE;40-49;483;734;1217
2020-05-25;CyL;40-49;4897;7035;11932
2020-05-25;LE;50-59;721;1071;1792
2020-05-25;SA;50-59;851;1334;2185
2020-05-25;SE;50-59;620;1014;1634
2020-05-25;SO;50-59;311;490;801
2020-05-25;VA;50-59;779;1269;2048
2020-05-25;BU;60-69;512;639;1151
2020-05-25;SO;60-69;216;272;488
2020-05-25;ZA;60-69;198;229;427
2020-05-25;LE;70-79;542;481;1023
2020-05-25;SE;70-79;343;311;654
2020-05-25;SO;70-79;153;125;278
2020-05-25;ZA;>80;209;319;528
2020-05-25;CyL;>80;4181;7359;11540
2020-05-25;SE;0-9;115;99;214
2020-05-25;SO;0-9;60;46;106
2020-05-25;CyL;10-19;1092;1074;2166
2020-05-25;BU;20-29;338;439;777
2020-05-25;LE;20-29;269;383;652
2020-05-25;ZA;20-29;68;94;162
2020-05-25;CyL;20-29;1948;2764;4712
2020-05-25;BU;30-39;573;763;1336
2020-05-25;PA;30-39;215;279;494
2020-05-25;SA;30-39;539;838;1377
2020-05-25;VA;30-39;655;985;1640
2020-05-25;ZA;30-39;122;191;313
2020-05-25;AV;40-49;370;533;903
2020-05-25;PA;40-49;318;377;695
2020-05-25;SA;40-49;745;1095;1840
2020-05-25;ZA;40-49;202;295;497
2020-05-25;PA;50-59;296;433;729
2020-05-25;ZA;50-59;206;340;546
2020-05-25;CyL;50-59;4902;7633;12535
2020-05-25;LE;60-69;618;770;1388
2020-05-25;VA;60-69;640;827;1467
2020-05-25;CyL;60-69;3915;4738;8653
2020-05-25;PA;70-79;164;175;339
2020-05-25;CyL;70-79;2912;2850;5762
2020-05-25;PA;>80;201;388;589
2020-05-25;SE;>80;551;871;1422
2020-05-25;SO;>80;341;614;955
2020-05-25;VA;>80;598;1217;1815
2020-05-25;AV;0-9;116;95;211
2020-05-25;PA;0-9;61;31;92
2020-05-25;SA;0-9;256;284;540
2020-05-25;CyL;0-9;1601;1436;3037
2020-05-25;BU;10-19;169;177;346
2020-05-25;LE;10-19;152;161;313
2020-05-25;SA;10-19;174;180;354
2020-05-25;ZA;10-19;64;71;135
2020-05-25;AV;20-29;142;198;340
2020-05-25;PA;20-29;134;144;278
2020-05-25;SA;20-29;326;496;822
2020-05-25;SE;20-29;185;277;462
2020-05-25;LE;30-39;477;763;1240
2020-05-25;SO;30-39;158;274;432
2020-05-25;CyL;30-39;3272;4874;8146
2020-05-25;LE;40-49;709;1102;1811
2020-05-25;SO;40-49;239;407;646
2020-05-25;VA;40-49;968;1387;2355
2020-05-25;AV;50-59;354;585;939
2020-05-25;BU;50-59;764;1097;1861
2020-05-25;AV;60-69;317;383;700
2020-05-25;PA;60-69;240;267;507
2020-05-25;SA;60-69;678;781;1459
2020-05-25;SE;60-69;496;570;1066
2020-05-25;AV;70-79;240;254;494
2020-05-25;BU;70-79;372;344;716
2020-05-25;SA;70-79;447;488;935
2020-05-25;VA;70-79;513;541;1054
2020-05-25;ZA;70-79;138;131;269
2020-05-25;AV;>80;371;576;947
2020-05-25;BU;>80;517;905;1422
2020-05-25;LE;>80;693;1244;1937
2020-05-25;SA;>80;700;1225;1925
2020-05-24;PA;10-19;76;54;130
2020-05-24;VA;10-19;234;240;474
2020-05-24;CyL;10-19;1082;1065;2147
2020-05-24;BU;20-29;337;433;770
2020-05-24;PA;20-29;134;144;278
2020-05-24;SO;20-29;103;157;260
2020-05-24;ZA;20-29;68;94;162
2020-05-24;AV;30-39;251;343;594
2020-05-24;BU;30-39;571;754;1325
2020-05-24;LE;30-39;474;761;1235
2020-05-24;SA;30-39;535;833;1368
2020-05-24;SE;30-39;277;437;714
2020-05-24;ZA;30-39;122;189;311
2020-05-24;CyL;30-39;3254;4846;8100
2020-05-24;BU;50-59;757;1080;1837
2020-05-24;LE;50-59;713;1066;1779
2020-05-24;SO;50-59;311;490;801
2020-05-24;PA;60-69;240;263;503
2020-05-24;SA;60-69;677;780;1457
2020-05-24;SO;60-69;212;272;484
2020-05-24;SA;70-79;443;484;927
2020-05-24;SE;70-79;341;309;650
2020-05-24;CyL;70-79;2896;2832;5728
2020-05-24;BU;>80;516;896;1412
2020-05-24;LE;>80;692;1242;1934
2020-05-24;PA;>80;202;389;591
2020-05-24;SE;>80;552;865;1417
2020-05-24;AV;0-9;115;94;209
2020-05-24;BU;0-9;199;154;353
2020-05-24;SO;0-9;56;45;101
2020-05-24;ZA;0-9;180;179;359
2020-05-24;CyL;0-9;1584;1414;2998
2020-05-24;AV;10-19;95;73;168
2020-05-24;BU;10-19;169;175;344
2020-05-24;SA;10-19;174;180;354
2020-05-24;SO;10-19;43;37;80
2020-05-24;LE;20-29;268;380;648
2020-05-24;SA;20-29;324;495;819
2020-05-24;SE;20-29;182;275;457
2020-05-24;VA;20-29;379;571;950
2020-05-24;SO;30-39;157;273;430
2020-05-24;PA;40-49;316;377;693
2020-05-24;SA;40-49;744;1091;1835
2020-05-24;SE;40-49;477;723;1200
2020-05-24;ZA;40-49;201;293;494
2020-05-24;CyL;40-49;4854;6994;11848
2020-05-24;AV;50-59;352;583;935
2020-05-24;SA;50-59;847;1333;2180
2020-05-24;CyL;50-59;4861;7562;12423
2020-05-24;LE;60-69;617;767;1384
2020-05-24;AV;70-79;240;251;491
2020-05-24;BU;70-79;368;343;711
2020-05-24;PA;70-79;163;173;336
2020-05-24;SO;70-79;153;125;278
2020-05-24;AV;>80;368;572;940
2020-05-24;SA;>80;701;1224;1925
2020-05-24;VA;>80;593;1213;1806
2020-05-24;ZA;>80;209;320;529
2020-05-24;CyL;>80;4176;7333;11509
2020-05-24;LE;0-9;222;201;423
2020-05-24;PA;0-9;62;30;92
2020-05-24;SA;0-9;256;283;539
2020-05-24;SE;0-9;114;97;211
2020-05-24;VA;0-9;380;331;711
2020-05-24;LE;10-19;150;161;311
2020-05-24;SE;10-19;78;75;153
2020-05-24;ZA;10-19;63;70;133
2020-05-24;AV;20-29;142;198;340
2020-05-24;CyL;20-29;1937;2747;4684
2020-05-24;PA;30-39;211;278;489
2020-05-24;VA;30-39;656;978;1634
2020-05-24;AV;40-49;367;533;900
2020-05-24;BU;40-49;853;1095;1948
2020-05-24;LE;40-49;707;1103;1810
2020-05-24;SO;40-49;237;404;641
2020-05-24;VA;40-49;952;1375;2327
2020-05-24;PA;50-59;292;425;717
2020-05-24;SE;50-59;612;993;1605
2020-05-24;VA;50-59;775;1254;2029
2020-05-24;ZA;50-59;202;338;540
2020-05-24;AV;60-69;316;383;699
2020-05-24;BU;60-69;505;633;1138
2020-05-24;SE;60-69;492;561;1053
2020-05-24;VA;60-69;632;820;1452
2020-05-24;ZA;60-69;196;226;422
2020-05-24;CyL;60-69;3887;4705;8592
2020-05-24;LE;70-79;540;481;1021
2020-05-24;VA;70-79;510;536;1046
2020-05-24;ZA;70-79;138;130;268
2020-05-24;SO;>80;343;612;955
2020-05-23;AV;0-9;115;94;209
2020-05-23;SO;0-9;56;45;101
2020-05-23;VA;0-9;380;331;711
2020-05-23;ZA;0-9;180;179;359
2020-05-23;BU;10-19;169;175;344
2020-05-23;LE;10-19;150;161;311
2020-05-23;ZA;10-19;63;70;133
2020-05-23;CyL;10-19;1081;1067;2148
2020-05-23;SA;20-29;324;495;819
2020-05-23;CyL;20-29;1936;2738;4674
2020-05-23;PA;30-39;211;278;489
2020-05-23;SE;30-39;276;433;709
2020-05-23;CyL;30-39;3250;4838;8088
2020-05-23;AV;40-49;367;532;899
2020-05-23;LE;40-49;707;1103;1810
2020-05-23;PA;40-49;316;377;693
2020-05-23;SE;40-49;475;719;1194
2020-05-23;SO;40-49;236;404;640
2020-05-23;VA;40-49;952;1374;2326
2020-05-23;CyL;40-49;4849;6983;11832
2020-05-23;BU;50-59;757;1080;1837
2020-05-23;PA;50-59;292;425;717
2020-05-23;SE;50-59;613;985;1598
2020-05-23;SO;50-59;311;490;801
2020-05-23;VA;50-59;775;1255;2030
2020-05-23;CyL;50-59;4861;7551;12412
2020-05-23;LE;60-69;615;767;1382
2020-05-23;SO;60-69;212;271;483
2020-05-23;VA;60-69;632;821;1453
2020-05-23;CyL;60-69;3881;4706;8587
2020-05-23;SA;70-79;443;484;927
2020-05-23;SO;70-79;153;125;278
2020-05-23;ZA;70-79;137;130;267
2020-05-23;BU;>80;515;896;1411
2020-05-23;PA;0-9;62;30;92
2020-05-23;SE;0-9;114;96;210
2020-05-23;CyL;0-9;1584;1413;2997
2020-05-23;PA;10-19;76;54;130
2020-05-23;SA;10-19;174;181;355
2020-05-23;SO;10-19;42;37;79
2020-05-23;VA;10-19;234;241;475
2020-05-23;AV;20-29;142;197;339
2020-05-23;BU;20-29;336;434;770
2020-05-23;SO;20-29;103;155;258
2020-05-23;AV;30-39;253;342;595
2020-05-23;SA;30-39;533;833;1366
2020-05-23;SO;30-39;156;269;425
2020-05-23;BU;40-49;854;1092;1946
2020-05-23;SA;40-49;741;1088;1829
2020-05-23;ZA;40-49;201;294;495
2020-05-23;LE;50-59;713;1063;1776
2020-05-23;SA;60-69;676;780;1456
2020-05-23;SE;60-69;491;561;1052
2020-05-23;AV;70-79;240;251;491
2020-05-23;BU;70-79;368;343;711
2020-05-23;LE;70-79;540;481;1021
2020-05-23;SE;70-79;341;309;650
2020-05-23;VA;70-79;510;536;1046
2020-05-23;CyL;70-79;2895;2832;5727
2020-05-23;SA;>80;701;1224;1925
2020-05-23;SE;>80;552;865;1417
2020-05-23;VA;>80;593;1212;1805
2020-05-23;ZA;>80;208;320;528
2020-05-23;CyL;>80;4170;7332;11502
2020-05-23;BU;0-9;199;154;353
2020-05-23;LE;0-9;222;201;423
2020-05-23;SA;0-9;256;283;539
2020-05-23;AV;10-19;95;73;168
2020-05-23;SE;10-19;78;75;153
2020-05-23;LE;20-29;267;377;644
2020-05-23;PA;20-29;134;145;279
2020-05-23;SE;20-29;183;270;453
2020-05-23;VA;20-29;379;571;950
2020-05-23;ZA;20-29;68;94;162
2020-05-23;BU;30-39;571;754;1325
2020-05-23;LE;30-39;473;763;1236
2020-05-23;VA;30-39;655;977;1632
2020-05-23;ZA;30-39;122;189;311
2020-05-23;AV;50-59;352;582;934
2020-05-23;SA;50-59;845;1333;2178
2020-05-23;ZA;50-59;203;338;541
2020-05-23;AV;60-69;315;382;697
2020-05-23;BU;60-69;505;633;1138
2020-05-23;PA;60-69;239;265;504
2020-05-23;ZA;60-69;196;226;422
2020-05-23;PA;70-79;163;173;336
2020-05-23;AV;>80;367;572;939
2020-05-23;LE;>80;690;1242;1932
2020-05-23;PA;>80;201;389;590
2020-05-23;SO;>80;343;612;955
2020-05-22;AV;0-9;115;94;209
2020-05-22;LE;0-9;221;201;422
2020-05-22;PA;0-9;62;30;92
2020-05-22;SO;0-9;56;44;100
2020-05-22;SA;10-19;174;181;355
2020-05-22;SO;10-19;42;37;79
2020-05-22;CyL;10-19;1079;1065;2144
2020-05-22;PA;20-29;134;144;278
2020-05-22;ZA;20-29;68;94;162
2020-05-22;CyL;20-29;1933;2723;4656
2020-05-22;LE;30-39;472;761;1233
2020-05-22;SE;30-39;275;425;700
2020-05-22;ZA;30-39;122;188;310
2020-05-22;BU;40-49;854;1094;1948
2020-05-22;SA;40-49;739;1086;1825
2020-05-22;SE;40-49;474;710;1184
2020-05-22;SO;40-49;234;403;637
2020-05-22;LE;50-59;712;1058;1770
2020-05-22;BU;60-69;503;633;1136
2020-05-22;PA;60-69;239;264;503
2020-05-22;CyL;70-79;2895;2830;5725
2020-05-22;AV;>80;368;571;939
2020-05-22;BU;>80;515;894;1409
2020-05-22;PA;>80;201;387;588
2020-05-22;SA;>80;701;1222;1923
2020-05-22;SO;>80;344;612;956
2020-05-22;CyL;>80;4170;7325;11495
2020-05-22;BU;0-9;198;153;351
2020-05-22;SE;0-9;114;95;209
2020-05-22;VA;0-9;380;329;709
2020-05-22;ZA;0-9;180;179;359
2020-05-22;CyL;0-9;1582;1408;2990
2020-05-22;BU;10-19;169;175;344
2020-05-22;PA;10-19;75;54;129
2020-05-22;SE;10-19;78;73;151
2020-05-22;VA;10-19;233;241;474
2020-05-22;SO;20-29;102;154;256
2020-05-22;VA;20-29;379;571;950
2020-05-22;SA;30-39;534;831;1365
2020-05-22;VA;30-39;654;972;1626
2020-05-22;CyL;30-39;3245;4822;8067
2020-05-22;PA;40-49;314;376;690
2020-05-22;VA;40-49;953;1374;2327
2020-05-22;ZA;40-49;201;294;495
2020-05-22;CyL;40-49;4842;6968;11810
2020-05-22;AV;50-59;352;581;933
2020-05-22;BU;50-59;755;1082;1837
2020-05-22;PA;50-59;292;426;718
2020-05-22;SE;50-59;610;972;1582
2020-05-22;SO;50-59;310;488;798
2020-05-22;ZA;50-59;201;337;538
2020-05-22;CyL;50-59;4848;7531;12379
2020-05-22;AV;60-69;315;381;696
2020-05-22;SA;60-69;674;779;1453
2020-05-22;VA;60-69;633;817;1450
2020-05-22;ZA;60-69;196;226;422
2020-05-22;AV;70-79;240;250;490
2020-05-22;BU;70-79;368;343;711
2020-05-22;LE;70-79;541;481;1022
2020-05-22;SE;70-79;341;308;649
2020-05-22;VA;70-79;510;536;1046
2020-05-22;LE;>80;690;1243;1933
2020-05-22;SE;>80;551;864;1415
2020-05-22;SA;0-9;256;283;539
2020-05-22;AV;10-19;95;73;168
2020-05-22;LE;10-19;150;161;311
2020-05-22;ZA;10-19;63;70;133
2020-05-22;AV;20-29;141;198;339
2020-05-22;BU;20-29;336;433;769
2020-05-22;LE;20-29;267;374;641
2020-05-22;SA;20-29;324;493;817
2020-05-22;SE;20-29;182;262;444
2020-05-22;AV;30-39;252;344;596
2020-05-22;BU;30-39;570;755;1325
2020-05-22;PA;30-39;210;278;488
2020-05-22;SO;30-39;156;268;424
2020-05-22;AV;40-49;367;531;898
2020-05-22;LE;40-49;706;1100;1806
2020-05-22;SA;50-59;842;1332;2174
2020-05-22;VA;50-59;774;1255;2029
2020-05-22;LE;60-69;614;766;1380
2020-05-22;SE;60-69;488;556;1044
2020-05-22;SO;60-69;211;266;477
2020-05-22;CyL;60-69;3873;4688;8561
2020-05-22;PA;70-79;162;173;335
2020-05-22;SA;70-79;443;483;926
2020-05-22;SO;70-79;153;125;278
2020-05-22;ZA;70-79;137;131;268
2020-05-22;VA;>80;592;1213;1805
2020-05-22;ZA;>80;208;319;527
2020-05-21;AV;0-9;114;94;208
2020-05-21;SA;0-9;255;279;534
2020-05-21;SE;0-9;114;93;207
2020-05-21;CyL;0-9;1576;1397;2973
2020-05-21;PA;10-19;75;54;129
2020-05-21;SO;10-19;43;36;79
2020-05-21;VA;10-19;228;238;466
2020-05-21;PA;20-29;133;143;276
2020-05-21;SA;20-29;322;491;813
2020-05-21;ZA;20-29;67;91;158
2020-05-21;LE;30-39;465;740;1205
2020-05-21;AV;40-49;365;524;889
2020-05-21;SA;40-49;735;1081;1816
2020-05-21;ZA;40-49;198;287;485
2020-05-21;SA;50-59;835;1329;2164
2020-05-21;CyL;50-59;4787;7447;12234
2020-05-21;LE;60-69;603;746;1349
2020-05-21;PA;60-69;234;258;492
2020-05-21;ZA;60-69;188;217;405
2020-05-21;CyL;60-69;3816;4634;8450
2020-05-21;LE;70-79;540;480;1020
2020-05-21;SO;70-79;152;123;275
2020-05-21;CyL;70-79;2878;2810;5688
2020-05-21;AV;>80;367;570;937
2020-05-21;BU;>80;515;890;1405
2020-05-21;SA;>80;699;1217;1916
2020-05-21;BU;0-9;199;152;351
2020-05-21;SO;0-9;54;44;98
2020-05-21;ZA;0-9;182;178;360
2020-05-21;AV;10-19;94;72;166
2020-05-21;LE;10-19;147;158;305
2020-05-21;AV;20-29;142;198;340
2020-05-21;BU;20-29;329;425;754
2020-05-21;LE;20-29;263;363;626
2020-05-21;SO;20-29;101;154;255
2020-05-21;CyL;20-29;1916;2693;4609
2020-05-21;AV;30-39;250;339;589
2020-05-21;BU;30-39;564;748;1312
2020-05-21;SO;30-39;156;268;424
2020-05-21;ZA;30-39;119;182;301
2020-05-21;BU;40-49;845;1085;1930
2020-05-21;LE;40-49;698;1068;1766
2020-05-21;SO;40-49;232;401;633
2020-05-21;VA;40-49;938;1370;2308
2020-05-21;AV;50-59;346;574;920
2020-05-21;PA;50-59;287;423;710
2020-05-21;SE;50-59;603;956;1559
2020-05-21;BU;60-69;499;628;1127
2020-05-21;AV;70-79;239;249;488
2020-05-21;BU;70-79;365;341;706
2020-05-21;SA;70-79;440;482;922
2020-05-21;VA;70-79;506;531;1037
2020-05-21;SE;>80;549;857;1406
2020-05-21;SO;>80;343;610;953
2020-05-21;VA;>80;587;1212;1799
2020-05-21;CyL;>80;4155;7299;11454
2020-05-21;LE;0-9;220;200;420
2020-05-21;PA;0-9;61;29;90
2020-05-21;VA;0-9;377;328;705
2020-05-21;BU;10-19;167;174;341
2020-05-21;SA;10-19;169;177;346
2020-05-21;SE;10-19;75;72;147
2020-05-21;ZA;10-19;62;67;129
2020-05-21;CyL;10-19;1060;1048;2108
2020-05-21;SE;20-29;181;262;443
2020-05-21;VA;20-29;378;566;944
2020-05-21;PA;30-39;210;272;482
2020-05-21;SA;30-39;532;825;1357
2020-05-21;SE;30-39;269;416;685
2020-05-21;VA;30-39;654;969;1623
2020-05-21;CyL;30-39;3219;4759;7978
2020-05-21;PA;40-49;313;375;688
2020-05-21;SE;40-49;469;693;1162
2020-05-21;CyL;40-49;4793;6884;11677
2020-05-21;BU;50-59;747;1069;1816
2020-05-21;LE;50-59;702;1030;1732
2020-05-21;SO;50-59;305;485;790
2020-05-21;VA;50-59;769;1252;2021
2020-05-21;ZA;50-59;193;329;522
2020-05-21;AV;60-69;312;379;691
2020-05-21;SA;60-69;666;779;1445
2020-05-21;SE;60-69;484;548;1032
2020-05-21;SO;60-69;208;264;472
2020-05-21;VA;60-69;622;815;1437
2020-05-21;PA;70-79;161;173;334
2020-05-21;SE;70-79;337;301;638
2020-05-21;ZA;70-79;138;130;268
2020-05-21;LE;>80;686;1240;1926
2020-05-21;PA;>80;201;386;587
2020-05-21;ZA;>80;208;317;525
2020-05-20;BU;0-9;199;153;352
2020-05-20;LE;0-9;217;197;414
2020-05-20;VA;0-9;376;322;698
2020-05-20;AV;10-19;94;72;166
2020-05-20;LE;10-19;143;152;295
2020-05-20;PA;10-19;76;52;128
2020-05-20;SA;10-19;168;175;343
2020-05-20;VA;10-19;226;235;461
2020-05-20;AV;20-29;141;199;340
2020-05-20;SO;20-29;100;152;252
2020-05-20;ZA;20-29;66;90;156
2020-05-20;LE;30-39;456;739;1195
2020-05-20;PA;30-39;210;271;481
2020-05-20;SA;30-39;532;819;1351
2020-05-20;BU;40-49;837;1075;1912
2020-05-20;LE;40-49;691;1060;1751
2020-05-20;SA;40-49;728;1074;1802
2020-05-20;SE;40-49;461;685;1146
2020-05-20;SO;40-49;230;400;630
2020-05-20;VA;40-49;932;1369;2301
2020-05-20;SA;50-59;831;1314;2145
2020-05-20;SO;60-69;208;263;471
2020-05-20;VA;60-69;616;808;1424
2020-05-20;ZA;60-69;186;210;396
2020-05-20;CyL;60-69;3787;4580;8367
2020-05-20;LE;>80;686;1232;1918
2020-05-20;SO;>80;341;609;950
2020-05-20;ZA;>80;208;316;524
2020-05-20;PA;0-9;61;29;90
2020-05-20;SA;0-9;252;277;529
2020-05-20;SE;0-9;111;92;203
2020-05-20;SO;0-9;51;44;95
2020-05-20;SE;10-19;74;71;145
2020-05-20;SO;10-19;42;36;78
2020-05-20;BU;20-29;327;420;747
2020-05-20;LE;20-29;258;361;619
2020-05-20;SA;20-29;319;489;808
2020-05-20;SE;20-29;178;257;435
2020-05-20;BU;30-39;564;744;1308
2020-05-20;VA;30-39;646;967;1613
2020-05-20;CyL;30-39;3197;4733;7930
2020-05-20;AV;40-49;363;519;882
2020-05-20;PA;40-49;313;373;686
2020-05-20;AV;50-59;342;573;915
2020-05-20;LE;50-59;694;1025;1719
2020-05-20;PA;50-59;283;417;700
2020-05-20;SE;50-59;586;940;1526
2020-05-20;SO;50-59;303;486;789
2020-05-20;VA;50-59;766;1244;2010
2020-05-20;ZA;50-59;188;321;509
2020-05-20;SA;60-69;661;772;1433
2020-05-20;LE;70-79;538;477;1015
2020-05-20;PA;70-79;156;171;327
2020-05-20;SE;70-79;336;300;636
2020-05-20;SO;70-79;150;123;273
2020-05-20;CyL;70-79;2859;2788;5647
2020-05-20;AV;>80;366;570;936
2020-05-20;SA;>80;699;1214;1913
2020-05-20;SE;>80;547;854;1401
2020-05-20;VA;>80;587;1209;1796
2020-05-20;AV;0-9;114;94;208
2020-05-20;ZA;0-9;182;174;356
2020-05-20;CyL;0-9;1563;1382;2945
2020-05-20;BU;10-19;165;172;337
2020-05-20;ZA;10-19;62;67;129
2020-05-20;CyL;10-19;1050;1032;2082
2020-05-20;PA;20-29;134;143;277
2020-05-20;VA;20-29;373;563;936
2020-05-20;CyL;20-29;1896;2674;4570
2020-05-20;AV;30-39;248;340;588
2020-05-20;SE;30-39;267;410;677
2020-05-20;SO;30-39;156;267;423
2020-05-20;ZA;30-39;118;176;294
2020-05-20;ZA;40-49;194;280;474
2020-05-20;CyL;40-49;4749;6835;11584
2020-05-20;BU;50-59;736;1061;1797
2020-05-20;CyL;50-59;4729;7381;12110
2020-05-20;AV;60-69;310;378;688
2020-05-20;BU;60-69;497;618;1115
2020-05-20;LE;60-69;596;739;1335
2020-05-20;PA;60-69;232;252;484
2020-05-20;SE;60-69;481;540;1021
2020-05-20;AV;70-79;236;247;483
2020-05-20;BU;70-79;364;339;703
2020-05-20;SA;70-79;439;475;914
2020-05-20;VA;70-79;503;527;1030
2020-05-20;ZA;70-79;137;129;266
2020-05-20;BU;>80;515;889;1404
2020-05-20;PA;>80;198;385;583
2020-05-20;CyL;>80;4147;7278;11425
2020-05-19;CyL;0-9;1547;1368;2915
2020-05-19;LE;10-19;141;149;290
2020-05-19;SA;10-19;165;172;337
2020-05-19;SO;10-19;42;36;78
2020-05-19;VA;10-19;223;232;455
2020-05-19;CyL;10-19;1034;1017;2051
2020-05-19;SO;20-29;100;151;251
2020-05-19;VA;20-29;370;561;931
2020-05-19;SE;30-39;268;403;671
2020-05-19;VA;30-39;644;959;1603
2020-05-19;AV;40-49;362;520;882
2020-05-19;LE;40-49;690;1058;1748
2020-05-19;PA;40-49;310;372;682
2020-05-19;SE;40-49;451;674;1125
2020-05-19;SO;40-49;232;398;630
2020-05-19;VA;40-49;929;1355;2284
2020-05-19;PA;50-59;277;411;688
2020-05-19;SA;50-59;832;1313;2145
2020-05-19;SE;50-59;577;913;1490
2020-05-19;SO;50-59;300;482;782
2020-05-19;ZA;50-59;184;311;495
2020-05-19;AV;60-69;309;375;684
2020-05-19;BU;60-69;494;608;1102
2020-05-19;PA;60-69;230;249;479
2020-05-19;SA;60-69;652;768;1420
2020-05-19;SO;60-69;206;262;468
2020-05-19;BU;70-79;361;336;697
2020-05-19;LE;70-79;535;474;1009
2020-05-19;SA;70-79;437;473;910
2020-05-19;VA;70-79;498;525;1023
2020-05-19;ZA;70-79;136;128;264
2020-05-19;LE;>80;684;1231;1915
2020-05-19;VA;>80;580;1207;1787
2020-05-19;AV;0-9;112;93;205
2020-05-19;LE;0-9;218;196;414
2020-05-19;PA;0-9;60;29;89
2020-05-19;SA;0-9;253;276;529
2020-05-19;VA;0-9;371;318;689
2020-05-19;AV;10-19;93;72;165
2020-05-19;PA;10-19;74;52;126
2020-05-19;AV;20-29;141;197;338
2020-05-19;BU;20-29;323;419;742
2020-05-19;LE;20-29;259;358;617
2020-05-19;PA;20-29;130;141;271
2020-05-19;ZA;20-29;64;88;152
2020-05-19;CyL;20-29;1878;2655;4533
2020-05-19;AV;30-39;245;340;585
2020-05-19;BU;30-39;556;737;1293
2020-05-19;LE;30-39;450;739;1189
2020-05-19;SA;30-39;529;819;1348
2020-05-19;SO;30-39;155;262;417
2020-05-19;BU;40-49;823;1070;1893
2020-05-19;SA;40-49;728;1072;1800
2020-05-19;ZA;40-49;186;276;462
2020-05-19;CyL;40-49;4711;6795;11506
2020-05-19;AV;50-59;337;572;909
2020-05-19;BU;50-59;732;1049;1781
2020-05-19;LE;50-59;686;1018;1704
2020-05-19;VA;50-59;753;1238;1991
2020-05-19;SE;60-69;474;534;1008
2020-05-19;VA;60-69;612;806;1418
2020-05-19;ZA;60-69;180;203;383
2020-05-19;AV;70-79;234;246;480
2020-05-19;SO;70-79;151;124;275
2020-05-19;BU;>80;514;884;1398
2020-05-19;PA;>80;197;385;582
2020-05-19;SO;>80;339;608;947
2020-05-19;CyL;>80;4126;7250;11376
2020-05-19;BU;0-9;196;150;346
2020-05-19;SE;0-9;108;89;197
2020-05-19;SO;0-9;51;44;95
2020-05-19;ZA;0-9;178;173;351
2020-05-19;BU;10-19;163;167;330
2020-05-19;SE;10-19;74;70;144
2020-05-19;ZA;10-19;59;67;126
2020-05-19;SA;20-29;316;486;802
2020-05-19;SE;20-29;175;254;429
2020-05-19;PA;30-39;207;272;479
2020-05-19;ZA;30-39;117;177;294
2020-05-19;CyL;30-39;3171;4708;7879
2020-05-19;CyL;50-59;4678;7307;11985
2020-05-19;LE;60-69;595;737;1332
2020-05-19;CyL;60-69;3752;4542;8294
2020-05-19;PA;70-79;156;172;328
2020-05-19;SE;70-79;333;296;629
2020-05-19;CyL;70-79;2841;2774;5615
2020-05-19;AV;>80;366;567;933
2020-05-19;SA;>80;693;1204;1897
2020-05-19;SE;>80;545;849;1394
2020-05-19;ZA;>80;208;315;523
2020-05-18;AV;0-9;112;93;205
2020-05-18;SA;0-9;251;276;527
2020-05-18;SO;0-9;51;45;96
2020-05-18;VA;0-9;367;315;682
2020-05-18;CyL;0-9;1535;1364;2899
2020-05-18;AV;10-19;93;72;165
2020-05-18;SO;10-19;41;36;77
2020-05-18;BU;20-29;317;412;729
2020-05-18;PA;20-29;129;141;270
2020-05-18;SA;20-29;314;484;798
2020-05-18;VA;20-29;366;550;916
2020-05-18;ZA;20-29;64;88;152
2020-05-18;LE;30-39;443;728;1171
2020-05-18;ZA;30-39;115;176;291
2020-05-18;AV;40-49;355;506;861
2020-05-18;AV;50-59;329;531;860
2020-05-18;LE;50-59;680;1014;1694
2020-05-18;ZA;50-59;183;307;490
2020-05-18;CyL;50-59;4629;7197;11826
2020-05-18;BU;60-69;493;600;1093
2020-05-18;SE;60-69;468;529;997
2020-05-18;VA;60-69;607;794;1401
2020-05-18;ZA;60-69;175;198;373
2020-05-18;SA;70-79;435;468;903
2020-05-18;SO;70-79;150;122;272
2020-05-18;BU;>80;513;875;1388
2020-05-18;SA;>80;694;1202;1896
2020-05-18;SE;>80;545;843;1388
2020-05-18;CyL;>80;4114;7221;11335
2020-05-18;BU;0-9;196;150;346
2020-05-18;LE;0-9;217;196;413
2020-05-18;PA;0-9;59;29;88
2020-05-18;SE;0-9;108;88;196
2020-05-18;ZA;0-9;174;172;346
2020-05-18;LE;10-19;138;149;287
2020-05-18;PA;10-19;72;51;123
2020-05-18;SA;10-19;163;171;334
2020-05-18;SE;10-19;70;68;138
2020-05-18;ZA;10-19;59;64;123
2020-05-18;AV;20-29;136;188;324
2020-05-18;CyL;20-29;1850;2621;4471
2020-05-18;PA;30-39;205;271;476
2020-05-18;SO;30-39;153;251;404
2020-05-18;VA;30-39;639;951;1590
2020-05-18;BU;40-49;823;1064;1887
2020-05-18;SE;40-49;448;663;1111
2020-05-18;SO;40-49;230;390;620
2020-05-18;VA;40-49;914;1345;2259
2020-05-18;ZA;40-49;182;266;448
2020-05-18;CyL;40-49;4658;6724;11382
2020-05-18;SE;50-59;572;896;1468
2020-05-18;VA;50-59;748;1218;1966
2020-05-18;AV;60-69;301;354;655
2020-05-18;LE;60-69;590;735;1325
2020-05-18;PA;60-69;228;249;477
2020-05-18;SA;60-69;652;762;1414
2020-05-18;BU;70-79;360;333;693
2020-05-18;PA;70-79;154;171;325
2020-05-18;SE;70-79;328;293;621
2020-05-18;CyL;70-79;2818;2750;5568
2020-05-18;AV;>80;365;566;931
2020-05-18;PA;>80;197;387;584
2020-05-18;VA;>80;577;1202;1779
2020-05-18;BU;10-19;160;166;326
2020-05-18;VA;10-19;221;230;451
2020-05-18;CyL;10-19;1017;1007;2024
2020-05-18;LE;20-29;252;357;609
2020-05-18;SE;20-29;172;252;424
2020-05-18;SO;20-29;100;149;249
2020-05-18;AV;30-39;244;332;576
2020-05-18;BU;30-39;553;728;1281
2020-05-18;SA;30-39;521;816;1337
2020-05-18;SE;30-39;267;397;664
2020-05-18;CyL;30-39;3140;4650;7790
2020-05-18;LE;40-49;687;1054;1741
2020-05-18;PA;40-49;302;370;672
2020-05-18;SA;40-49;717;1066;1783
2020-05-18;BU;50-59;717;1042;1759
2020-05-18;PA;50-59;274;410;684
2020-05-18;SA;50-59;826;1304;2130
2020-05-18;SO;50-59;300;475;775
2020-05-18;SO;60-69;204;261;465
2020-05-18;CyL;60-69;3718;4482;8200
2020-05-18;AV;70-79;233;246;479
2020-05-18;LE;70-79;532;469;1001
2020-05-18;VA;70-79;493;522;1015
2020-05-18;ZA;70-79;133;126;259
2020-05-18;LE;>80;681;1224;1905
2020-05-18;SO;>80;338;608;946
2020-05-18;ZA;>80;204;314;518
2020-05-17;SA;0-9;251;276;527
2020-05-17;SO;0-9;52;44;96
2020-05-17;CyL;0-9;1524;1350;2874
2020-05-17;AV;10-19;92;73;165
2020-05-17;BU;10-19;157;164;321
2020-05-17;LE;10-19;137;147;284
2020-05-17;PA;10-19;71;50;121
2020-05-17;SA;10-19;162;170;332
2020-05-17;SO;10-19;40;36;76
2020-05-17;VA;10-19;218;226;444
2020-05-17;AV;20-29;135;187;322
2020-05-17;BU;20-29;314;409;723
2020-05-17;LE;20-29;254;355;609
2020-05-17;SE;20-29;170;249;419
2020-05-17;SO;20-29;99;148;247
2020-05-17;PA;30-39;199;269;468
2020-05-17;CyL;30-39;3108;4612;7720
2020-05-17;AV;40-49;357;503;860
2020-05-17;BU;40-49;801;1042;1843
2020-05-17;LE;50-59;679;1012;1691
2020-05-17;VA;50-59;738;1210;1948
2020-05-17;AV;60-69;302;352;654
2020-05-17;LE;60-69;585;726;1311
2020-05-17;SE;60-69;465;518;983
2020-05-17;SO;60-69;205;262;467
2020-05-17;AV;70-79;233;245;478
2020-05-17;LE;70-79;529;466;995
2020-05-17;ZA;70-79;131;122;253
2020-05-17;CyL;70-79;2808;2730;5538
2020-05-17;PA;>80;196;388;584
2020-05-17;SA;>80;696;1198;1894
2020-05-17;SE;>80;542;841;1383
2020-05-17;CyL;>80;4097;7209;11306
2020-05-17;LE;0-9;215;196;411
2020-05-17;PA;0-9;58;29;87
2020-05-17;ZA;0-9;175;166;341
2020-05-17;CyL;10-19;1003;998;2001
2020-05-17;CyL;20-29;1832;2605;4437
2020-05-17;AV;30-39;244;332;576
2020-05-17;BU;30-39;541;718;1259
2020-05-17;SE;30-39;267;389;656
2020-05-17;SO;30-39;152;246;398
2020-05-17;ZA;30-39;115;179;294
2020-05-17;PA;40-49;299;368;667
2020-05-17;SA;40-49;704;1059;1763
2020-05-17;SE;40-49;443;650;1093
2020-05-17;CyL;40-49;4591;6648;11239
2020-05-17;AV;50-59;326;524;850
2020-05-17;BU;50-59;709;1032;1741
2020-05-17;SA;50-59;818;1304;2122
2020-05-17;SE;50-59;565;878;1443
2020-05-17;SO;50-59;297;467;764
2020-05-17;ZA;50-59;185;303;488
2020-05-17;BU;70-79;359;332;691
2020-05-17;SA;70-79;434;468;902
2020-05-17;SE;70-79;327;289;616
2020-05-17;SO;70-79;149;120;269
2020-05-17;AV;>80;364;564;928
2020-05-17;LE;>80;678;1224;1902
2020-05-17;VA;>80;574;1199;1773
2020-05-17;AV;0-9;112;92;204
2020-05-17;BU;0-9;196;149;345
2020-05-17;SE;0-9;108;87;195
2020-05-17;VA;0-9;357;311;668
2020-05-17;SE;10-19;69;68;137
2020-05-17;ZA;10-19;57;64;121
2020-05-17;PA;20-29;126;140;266
2020-05-17;SA;20-29;310;480;790
2020-05-17;VA;20-29;360;549;909
2020-05-17;ZA;20-29;64;88;152
2020-05-17;LE;30-39;438;724;1162
2020-05-17;SA;30-39;517;808;1325
2020-05-17;VA;30-39;635;947;1582
2020-05-17;LE;40-49;679;1048;1727
2020-05-17;SO;40-49;228;385;613
2020-05-17;VA;40-49;901;1333;2234
2020-05-17;ZA;40-49;179;260;439
2020-05-17;PA;50-59;272;406;678
2020-05-17;CyL;50-59;4589;7136;11725
2020-05-17;BU;60-69;487;592;1079
2020-05-17;PA;60-69;225;245;470
2020-05-17;SA;60-69;650;755;1405
2020-05-17;VA;60-69;602;788;1390
2020-05-17;ZA;60-69;175;197;372
2020-05-17;CyL;60-69;3696;4435;8131
2020-05-17;PA;70-79;154;172;326
2020-05-17;VA;70-79;492;516;1008
2020-05-17;BU;>80;510;876;1386
2020-05-17;SO;>80;336;606;942
2020-05-17;ZA;>80;201;313;514
2020-05-16;SE;0-9;108;87;195
2020-05-16;VA;0-9;356;310;666
2020-05-16;AV;10-19;91;73;164
2020-05-16;BU;10-19;157;164;321
2020-05-16;LE;10-19;138;147;285
2020-05-16;CyL;10-19;1001;998;1999
2020-05-16;BU;20-29;314;409;723
2020-05-16;SA;20-29;308;480;788
2020-05-16;SE;20-29;170;248;418
2020-05-16;VA;20-29;360;549;909
2020-05-16;BU;30-39;540;718;1258
2020-05-16;SA;30-39;516;808;1324
2020-05-16;VA;30-39;634;948;1582
2020-05-16;ZA;30-39;115;179;294
2020-05-16;CyL;30-39;3098;4607;7705
2020-05-16;AV;40-49;354;505;859
2020-05-16;PA;40-49;299;367;666
2020-05-16;SE;40-49;439;646;1085
2020-05-16;VA;40-49;901;1333;2234
2020-05-16;CyL;40-49;4582;6646;11228
2020-05-16;BU;50-59;707;1030;1737
2020-05-16;SA;50-59;819;1304;2123
2020-05-16;SO;50-59;297;468;765
2020-05-16;BU;60-69;487;593;1080
2020-05-16;PA;60-69;225;246;471
2020-05-16;SA;60-69;650;755;1405
2020-05-16;SE;60-69;462;515;977
2020-05-16;VA;60-69;599;788;1387
2020-05-16;PA;70-79;154;171;325
2020-05-16;SA;70-79;434;468;902
2020-05-16;CyL;70-79;2805;2724;5529
2020-05-16;VA;>80;574;1198;1772
2020-05-16;AV;0-9;112;92;204
2020-05-16;LE;0-9;215;196;411
2020-05-16;SA;0-9;251;276;527
2020-05-16;PA;10-19;70;50;120
2020-05-16;SO;10-19;40;36;76
2020-05-16;VA;10-19;218;226;444
2020-05-16;ZA;10-19;57;64;121
2020-05-16;PA;20-29;126;140;266
2020-05-16;SO;20-29;98;148;246
2020-05-16;SE;30-39;265;384;649
2020-05-16;LE;40-49;679;1046;1725
2020-05-16;ZA;40-49;179;261;440
2020-05-16;SE;50-59;563;868;1431
2020-05-16;VA;50-59;736;1209;1945
2020-05-16;ZA;50-59;185;303;488
2020-05-16;LE;60-69;585;725;1310
2020-05-16;SO;60-69;205;262;467
2020-05-16;ZA;60-69;175;197;372
2020-05-16;CyL;60-69;3689;4432;8121
2020-05-16;AV;70-79;233;245;478
2020-05-16;BU;70-79;360;332;692
2020-05-16;LE;70-79;527;464;991
2020-05-16;SE;70-79;326;288;614
2020-05-16;SO;70-79;148;120;268
2020-05-16;VA;70-79;492;514;1006
2020-05-16;AV;>80;363;564;927
2020-05-16;BU;>80;508;876;1384
2020-05-16;PA;>80;196;388;584
2020-05-16;SE;>80;540;833;1373
2020-05-16;SO;>80;336;606;942
2020-05-16;BU;0-9;195;148;343
2020-05-16;PA;0-9;58;29;87
2020-05-16;SO;0-9;52;43;95
2020-05-16;ZA;0-9;174;166;340
2020-05-16;CyL;0-9;1521;1347;2868
2020-05-16;SA;10-19;162;170;332
2020-05-16;SE;10-19;68;68;136
2020-05-16;AV;20-29;135;188;323
2020-05-16;LE;20-29;254;357;611
2020-05-16;ZA;20-29;64;88;152
2020-05-16;CyL;20-29;1829;2607;4436
2020-05-16;AV;30-39;242;331;573
2020-05-16;LE;30-39;437;723;1160
2020-05-16;PA;30-39;199;269;468
2020-05-16;SO;30-39;150;247;397
2020-05-16;BU;40-49;802;1044;1846
2020-05-16;SA;40-49;702;1058;1760
2020-05-16;SO;40-49;227;386;613
2020-05-16;AV;50-59;325;527;852
2020-05-16;LE;50-59;679;1010;1689
2020-05-16;PA;50-59;271;406;677
2020-05-16;CyL;50-59;4582;7125;11707
2020-05-16;AV;60-69;301;351;652
2020-05-16;ZA;70-79;131;122;253
2020-05-16;LE;>80;676;1219;1895
2020-05-16;SA;>80;696;1198;1894
2020-05-16;ZA;>80;201;314;515
2020-05-16;CyL;>80;4090;7196;11286
2020-05-15;AV;0-9;111;92;203
2020-05-15;PA;0-9;58;29;87
2020-05-15;SO;0-9;51;43;94
2020-05-15;CyL;0-9;1517;1345;2862
2020-05-15;AV;10-19;91;72;163
2020-05-15;BU;10-19;157;163;320
2020-05-15;PA;10-19;69;50;119
2020-05-15;PA;20-29;127;140;267
2020-05-15;SE;20-29;169;245;414
2020-05-15;ZA;20-29;64;88;152
2020-05-15;SA;30-39;514;804;1318
2020-05-15;SO;30-39;149;245;394
2020-05-15;CyL;30-39;3086;4591;7677
2020-05-15;AV;40-49;353;505;858
2020-05-15;BU;40-49;801;1038;1839
2020-05-15;AV;50-59;325;523;848
2020-05-15;SE;50-59;558;857;1415
2020-05-15;VA;50-59;735;1207;1942
2020-05-15;AV;60-69;300;351;651
2020-05-15;BU;60-69;485;586;1071
2020-05-15;PA;60-69;225;246;471
2020-05-15;ZA;60-69;175;197;372
2020-05-15;AV;70-79;233;246;479
2020-05-15;ZA;70-79;130;121;251
2020-05-15;BU;>80;507;874;1381
2020-05-15;LE;>80;675;1217;1892
2020-05-15;SA;>80;695;1196;1891
2020-05-15;SO;>80;335;606;941
2020-05-15;CyL;>80;4087;7181;11268
2020-05-15;BU;0-9;193;147;340
2020-05-15;LE;0-9;215;196;411
2020-05-15;LE;10-19;137;147;284
2020-05-15;SA;10-19;162;170;332
2020-05-15;SE;10-19;68;68;136
2020-05-15;SO;10-19;40;36;76
2020-05-15;ZA;10-19;57;64;121
2020-05-15;BU;20-29;314;407;721
2020-05-15;SO;20-29;98;146;244
2020-05-15;CyL;20-29;1828;2596;4424
2020-05-15;BU;30-39;538;714;1252
2020-05-15;ZA;30-39;115;179;294
2020-05-15;PA;40-49;297;369;666
2020-05-15;SO;40-49;227;385;612
2020-05-15;VA;40-49;901;1331;2232
2020-05-15;CyL;40-49;4571;6625;11196
2020-05-15;BU;50-59;704;1027;1731
2020-05-15;PA;50-59;270;403;673
2020-05-15;LE;60-69;585;726;1311
2020-05-15;SO;60-69;205;262;467
2020-05-15;CyL;60-69;3683;4420;8103
2020-05-15;LE;70-79;525;463;988
2020-05-15;SE;70-79;324;286;610
2020-05-15;VA;70-79;490;513;1003
2020-05-15;AV;>80;364;564;928
2020-05-15;PA;>80;195;388;583
2020-05-15;VA;>80;575;1194;1769
2020-05-15;SA;0-9;252;276;528
2020-05-15;SE;0-9;107;87;194
2020-05-15;VA;0-9;356;309;665
2020-05-15;ZA;0-9;174;166;340
2020-05-15;VA;10-19;216;226;442
2020-05-15;CyL;10-19;997;996;1993
2020-05-15;AV;20-29;135;187;322
2020-05-15;LE;20-29;254;356;610
2020-05-15;SA;20-29;307;479;786
2020-05-15;VA;20-29;360;548;908
2020-05-15;AV;30-39;242;331;573
2020-05-15;LE;30-39;434;721;1155
2020-05-15;PA;30-39;198;270;468
2020-05-15;SE;30-39;264;382;646
2020-05-15;VA;30-39;632;945;1577
2020-05-15;LE;40-49;679;1044;1723
2020-05-15;SA;40-49;702;1055;1757
2020-05-15;SE;40-49;433;638;1071
2020-05-15;ZA;40-49;178;260;438
2020-05-15;LE;50-59;679;1006;1685
2020-05-15;SA;50-59;818;1302;2120
2020-05-15;SO;50-59;296;467;763
2020-05-15;ZA;50-59;182;302;484
2020-05-15;CyL;50-59;4567;7094;11661
2020-05-15;SA;60-69;650;753;1403
2020-05-15;SE;60-69;459;513;972
2020-05-15;VA;60-69;599;786;1385
2020-05-15;BU;70-79;358;332;690
2020-05-15;PA;70-79;154;171;325
2020-05-15;SA;70-79;434;467;901
2020-05-15;SO;70-79;149;120;269
2020-05-15;CyL;70-79;2797;2719;5516
2020-05-15;SE;>80;540;829;1369
2020-05-15;ZA;>80;201;313;514
2020-05-14;LE;0-9;215;193;408
2020-05-14;SE;0-9;105;85;190
2020-05-14;SO;0-9;51;39;90
2020-05-14;BU;10-19;155;163;318
2020-05-14;SO;10-19;40;35;75
2020-05-14;VA;10-19;215;225;440
2020-05-14;BU;20-29;313;401;714
2020-05-14;PA;20-29;126;138;264
2020-05-14;LE;30-39;434;716;1150
2020-05-14;PA;30-39;197;267;464
2020-05-14;ZA;30-39;111;171;282
2020-05-14;AV;40-49;347;501;848
2020-05-14;LE;40-49;673;1036;1709
2020-05-14;SA;40-49;696;1037;1733
2020-05-14;VA;40-49;888;1326;2214
2020-05-14;ZA;40-49;176;256;432
2020-05-14;CyL;40-49;4521;6564;11085
2020-05-14;AV;50-59;325;520;845
2020-05-14;SA;50-59;813;1282;2095
2020-05-14;SE;50-59;548;849;1397
2020-05-14;VA;50-59;732;1196;1928
2020-05-14;AV;60-69;299;351;650
2020-05-14;BU;60-69;485;573;1058
2020-05-14;VA;60-69;596;780;1376
2020-05-14;CyL;60-69;3662;4374;8036
2020-05-14;AV;70-79;232;246;478
2020-05-14;LE;70-79;521;459;980
2020-05-14;SO;70-79;147;120;267
2020-05-14;ZA;70-79;131;121;252
2020-05-14;BU;>80;508;870;1378
2020-05-14;PA;>80;196;389;585
2020-05-14;SE;>80;536;827;1363
2020-05-14;CyL;>80;4080;7152;11232
2020-05-14;BU;0-9;190;146;336
2020-05-14;AV;10-19;90;72;162
2020-05-14;AV;20-29;132;184;316
2020-05-14;LE;20-29;251;351;602
2020-05-14;SE;20-29;167;238;405
2020-05-14;SO;20-29;98;145;243
2020-05-14;VA;20-29;362;543;905
2020-05-14;BU;30-39;529;710;1239
2020-05-14;SE;30-39;263;376;639
2020-05-14;CyL;30-39;3056;4548;7604
2020-05-14;PA;40-49;296;370;666
2020-05-14;SE;40-49;423;634;1057
2020-05-14;BU;50-59;694;1012;1706
2020-05-14;LE;60-69;580;723;1303
2020-05-14;SA;60-69;648;741;1389
2020-05-14;SO;60-69;204;262;466
2020-05-14;BU;70-79;357;329;686
2020-05-14;CyL;70-79;2783;2702;5485
2020-05-14;AV;>80;366;565;931
2020-05-14;LE;>80;676;1209;1885
2020-05-14;SA;>80;693;1194;1887
2020-05-14;ZA;>80;197;310;507
2020-05-14;AV;0-9;109;92;201
2020-05-14;PA;0-9;57;29;86
2020-05-14;SA;0-9;251;274;525
2020-05-14;VA;0-9;351;308;659
2020-05-14;ZA;0-9;170;166;336
2020-05-14;CyL;0-9;1499;1332;2831
2020-05-14;LE;10-19;136;147;283
2020-05-14;PA;10-19;68;51;119
2020-05-14;SA;10-19;156;166;322
2020-05-14;SE;10-19;68;67;135
2020-05-14;ZA;10-19;58;62;120
2020-05-14;CyL;10-19;986;988;1974
2020-05-14;SA;20-29;302;477;779
2020-05-14;ZA;20-29;62;88;150
2020-05-14;CyL;20-29;1813;2565;4378
2020-05-14;AV;30-39;235;326;561
2020-05-14;SA;30-39;514;801;1315
2020-05-14;SO;30-39;146;240;386
2020-05-14;VA;30-39;627;941;1568
2020-05-14;BU;40-49;797;1025;1822
2020-05-14;SO;40-49;225;379;604
2020-05-14;LE;50-59;676;995;1671
2020-05-14;PA;50-59;267;406;673
2020-05-14;SO;50-59;294;459;753
2020-05-14;ZA;50-59;182;294;476
2020-05-14;CyL;50-59;4531;7013;11544
2020-05-14;PA;60-69;224;245;469
2020-05-14;SE;60-69;453;509;962
2020-05-14;ZA;60-69;173;190;363
2020-05-14;PA;70-79;155;168;323
2020-05-14;SA;70-79;433;468;901
2020-05-14;SE;70-79;321;283;604
2020-05-14;VA;70-79;486;508;994
2020-05-14;SO;>80;332;603;935
2020-05-14;VA;>80;576;1185;1761
2020-05-13;AV;0-9;109;91;200
2020-05-13;PA;0-9;57;29;86
2020-05-13;SO;0-9;50;37;87
2020-05-13;ZA;0-9;167;164;331
2020-05-13;CyL;0-9;1483;1316;2799
2020-05-13;BU;10-19;154;163;317
2020-05-13;LE;10-19;133;145;278
2020-05-13;PA;10-19;68;51;119
2020-05-13;ZA;10-19;55;60;115
2020-05-13;CyL;10-19;973;978;1951
2020-05-13;LE;20-29;251;353;604
2020-05-13;PA;20-29;126;141;267
2020-05-13;SO;20-29;95;143;238
2020-05-13;AV;30-39;237;327;564
2020-05-13;BU;30-39;524;703;1227
2020-05-13;PA;30-39;197;265;462
2020-05-13;CyL;30-39;3035;4511;7546
2020-05-13;BU;40-49;763;1017;1780
2020-05-13;CyL;40-49;4444;6515;10959
2020-05-13;BU;50-59;667;995;1662
2020-05-13;PA;50-59;264;397;661
2020-05-13;SA;50-59;800;1269;2069
2020-05-13;SO;50-59;289;454;743
2020-05-13;LE;60-69;573;719;1292
2020-05-13;SE;60-69;447;497;944
2020-05-13;SO;60-69;201;259;460
2020-05-13;CyL;60-69;3627;4327;7954
2020-05-13;BU;70-79;357;327;684
2020-05-13;LE;70-79;516;452;968
2020-05-13;SA;70-79;431;466;897
2020-05-13;ZA;70-79;128;120;248
2020-05-13;BU;>80;506;866;1372
2020-05-13;SE;>80;537;822;1359
2020-05-13;ZA;>80;195;311;506
2020-05-13;CyL;>80;4069;7133;11202
2020-05-13;LE;0-9;212;192;404
2020-05-13;VA;0-9;351;303;654
2020-05-13;AV;10-19;88;69;157
2020-05-13;SA;10-19;156;165;321
2020-05-13;SE;10-19;67;66;133
2020-05-13;SO;10-19;39;35;74
2020-05-13;BU;20-29;309;400;709
2020-05-13;SA;20-29;302;469;771
2020-05-13;ZA;20-29;60;87;147
2020-05-13;CyL;20-29;1791;2543;4334
2020-05-13;LE;30-39;431;713;1144
2020-05-13;SA;30-39;508;794;1302
2020-05-13;SE;30-39;259;373;632
2020-05-13;SO;30-39;142;235;377
2020-05-13;PA;40-49;296;367;663
2020-05-13;SA;40-49;689;1023;1712
2020-05-13;ZA;40-49;171;258;429
2020-05-13;LE;50-59;667;993;1660
2020-05-13;SE;50-59;534;827;1361
2020-05-13;VA;50-59;729;1191;1920
2020-05-13;CyL;50-59;4452;6929;11381
2020-05-13;VA;60-69;592;773;1365
2020-05-13;AV;70-79;229;243;472
2020-05-13;SE;70-79;321;277;598
2020-05-13;VA;70-79;479;503;982
2020-05-13;CyL;70-79;2762;2671;5433
2020-05-13;PA;>80;194;384;578
2020-05-13;SO;>80;331;603;934
2020-05-13;VA;>80;577;1180;1757
2020-05-13;BU;0-9;189;143;332
2020-05-13;SA;0-9;246;272;518
2020-05-13;SE;0-9;102;85;187
2020-05-13;VA;10-19;213;224;437
2020-05-13;AV;20-29;131;184;315
2020-05-13;SE;20-29;162;232;394
2020-05-13;VA;20-29;355;534;889
2020-05-13;VA;30-39;627;933;1560
2020-05-13;ZA;30-39;110;168;278
2020-05-13;AV;40-49;343;499;842
2020-05-13;LE;40-49;665;1039;1704
2020-05-13;SE;40-49;418;619;1037
2020-05-13;SO;40-49;221;377;598
2020-05-13;VA;40-49;878;1316;2194
2020-05-13;AV;50-59;323;514;837
2020-05-13;ZA;50-59;179;289;468
2020-05-13;AV;60-69;296;350;646
2020-05-13;BU;60-69;478;564;1042
2020-05-13;PA;60-69;225;240;465
2020-05-13;SA;60-69;642;739;1381
2020-05-13;ZA;60-69;173;186;359
2020-05-13;PA;70-79;154;164;318
2020-05-13;SO;70-79;147;119;266
2020-05-13;AV;>80;365;565;930
2020-05-13;LE;>80;673;1207;1880
2020-05-13;SA;>80;691;1195;1886
2020-05-12;BU;0-9;189;141;330
2020-05-12;LE;0-9;209;190;399
2020-05-12;PA;0-9;56;29;85
2020-05-12;SE;0-9;102;85;187
2020-05-12;SO;0-9;49;37;86
2020-05-12;CyL;0-9;1476;1301;2777
2020-05-12;LE;10-19;131;146;277
2020-05-12;SA;10-19;155;165;320
2020-05-12;SO;10-19;38;35;73
2020-05-12;AV;20-29;132;181;313
2020-05-12;LE;20-29;249;348;597
2020-05-12;SA;20-29;298;465;763
2020-05-12;SE;20-29;158;231;389
2020-05-12;VA;20-29;353;531;884
2020-05-12;CyL;20-29;1768;2508;4276
2020-05-12;AV;30-39;234;322;556
2020-05-12;LE;30-39;429;709;1138
2020-05-12;PA;30-39;192;261;453
2020-05-12;ZA;30-39;107;166;273
2020-05-12;AV;40-49;339;496;835
2020-05-12;PA;40-49;293;366;659
2020-05-12;ZA;40-49;168;253;421
2020-05-12;SE;50-59;529;820;1349
2020-05-12;VA;50-59;727;1186;1913
2020-05-12;BU;60-69;470;551;1021
2020-05-12;PA;60-69;222;239;461
2020-05-12;SA;60-69;636;730;1366
2020-05-12;SE;60-69;443;486;929
2020-05-12;CyL;60-69;3596;4279;7875
2020-05-12;LE;70-79;515;448;963
2020-05-12;PA;70-79;154;164;318
2020-05-12;CyL;70-79;2744;2648;5392
2020-05-12;LE;>80;668;1196;1864
2020-05-12;PA;>80;192;385;577
2020-05-12;SA;>80;684;1185;1869
2020-05-12;VA;>80;569;1177;1746
2020-05-12;SA;0-9;246;271;517
2020-05-12;AV;10-19;87;67;154
2020-05-12;PA;10-19;68;50;118
2020-05-12;ZA;10-19;54;58;112
2020-05-12;BU;20-29;301;390;691
2020-05-12;SO;20-29;94;138;232
2020-05-12;BU;30-39;522;695;1217
2020-05-12;SE;30-39;254;362;616
2020-05-12;CyL;30-39;3005;4454;7459
2020-05-12;LE;40-49;659;1036;1695
2020-05-12;SE;40-49;415;611;1026
2020-05-12;SO;40-49;216;366;582
2020-05-12;VA;40-49;876;1315;2191
2020-05-12;PA;50-59;262;393;655
2020-05-12;SA;50-59;793;1260;2053
2020-05-12;SO;50-59;282;441;723
2020-05-12;CyL;50-59;4406;6858;11264
2020-05-12;AV;60-69;296;350;646
2020-05-12;ZA;60-69;171;181;352
2020-05-12;AV;70-79;230;242;472
2020-05-12;BU;70-79;357;326;683
2020-05-12;SE;70-79;320;274;594
2020-05-12;BU;>80;502;863;1365
2020-05-12;SE;>80;530;820;1350
2020-05-12;SO;>80;330;602;932
2020-05-12;AV;0-9;108;91;199
2020-05-12;VA;0-9;351;300;651
2020-05-12;ZA;0-9;166;157;323
2020-05-12;BU;10-19;151;162;313
2020-05-12;SE;10-19;68;66;134
2020-05-12;VA;10-19;212;222;434
2020-05-12;CyL;10-19;964;971;1935
2020-05-12;PA;20-29;124;137;261
2020-05-12;ZA;20-29;59;87;146
2020-05-12;SA;30-39;503;788;1291
2020-05-12;SO;30-39;142;223;365
2020-05-12;VA;30-39;622;928;1550
2020-05-12;BU;40-49;738;1002;1740
2020-05-12;SA;40-49;680;1014;1694
2020-05-12;CyL;40-49;4384;6459;10843
2020-05-12;AV;50-59;324;512;836
2020-05-12;BU;50-59;652;974;1626
2020-05-12;LE;50-59;658;989;1647
2020-05-12;ZA;50-59;179;283;462
2020-05-12;LE;60-69;568;714;1282
2020-05-12;SO;60-69;198;256;454
2020-05-12;VA;60-69;592;772;1364
2020-05-12;SA;70-79;429;458;887
2020-05-12;SO;70-79;145;118;263
2020-05-12;VA;70-79;475;502;977
2020-05-12;ZA;70-79;119;116;235
2020-05-12;AV;>80;362;565;927
2020-05-12;ZA;>80;181;276;457
2020-05-12;CyL;>80;4018;7069;11087
2020-05-11;PA;10-19;67;49;116
2020-05-11;SE;10-19;65;65;130
2020-05-11;AV;20-29;130;180;310
2020-05-11;LE;20-29;249;348;597
2020-05-11;SE;30-39;250;356;606
2020-05-11;CyL;30-39;2963;4404;7367
2020-05-11;BU;40-49;725;995;1720
2020-05-11;SE;40-49;414;600;1014
2020-05-11;LE;50-59;652;988;1640
2020-05-11;VA;50-59;722;1169;1891
2020-05-11;LE;60-69;563;712;1275
2020-05-11;SO;60-69;193;251;444
2020-05-11;ZA;60-69;167;174;341
2020-05-11;SO;70-79;144;118;262
2020-05-11;ZA;70-79;112;110;222
2020-05-11;LE;>80;661;1186;1847
2020-05-11;VA;>80;563;1167;1730
2020-05-11;LE;0-9;205;187;392
2020-05-11;SO;0-9;48;35;83
2020-05-11;CyL;0-9;1463;1287;2750
2020-05-11;AV;10-19;86;66;152
2020-05-11;BU;10-19;150;159;309
2020-05-11;SA;10-19;154;164;318
2020-05-11;PA;20-29;124;135;259
2020-05-11;ZA;20-29;56;85;141
2020-05-11;CyL;20-29;1741;2482;4223
2020-05-11;BU;30-39;518;688;1206
2020-05-11;PA;30-39;189;262;451
2020-05-11;SO;30-39;140;218;358
2020-05-11;PA;40-49;291;361;652
2020-05-11;SA;40-49;659;1000;1659
2020-05-11;SO;40-49;217;362;579
2020-05-11;ZA;40-49;164;254;418
2020-05-11;AV;50-59;319;508;827
2020-05-11;PA;50-59;261;382;643
2020-05-11;SO;50-59;277;432;709
2020-05-11;ZA;50-59;173;282;455
2020-05-11;CyL;50-59;4338;6762;11100
2020-05-11;AV;60-69;294;349;643
2020-05-11;SA;60-69;629;724;1353
2020-05-11;VA;60-69;589;771;1360
2020-05-11;AV;70-79;230;240;470
2020-05-11;LE;70-79;510;446;956
2020-05-11;PA;>80;190;382;572
2020-05-11;ZA;>80;179;272;451
2020-05-11;CyL;>80;3981;6999;10980
2020-05-11;AV;0-9;105;90;195
2020-05-11;BU;0-9;189;140;329
2020-05-11;PA;0-9;55;29;84
2020-05-11;SA;0-9;244;272;516
2020-05-11;SE;0-9;101;84;185
2020-05-11;VA;0-9;352;296;648
2020-05-11;ZA;0-9;164;154;318
2020-05-11;LE;10-19;129;144;273
2020-05-11;SO;10-19;38;34;72
2020-05-11;VA;10-19;208;218;426
2020-05-11;ZA;10-19;52;58;110
2020-05-11;CyL;10-19;949;957;1906
2020-05-11;BU;20-29;293;388;681
2020-05-11;SA;20-29;292;458;750
2020-05-11;SE;20-29;156;231;387
2020-05-11;SO;20-29;95;133;228
2020-05-11;VA;20-29;346;524;870
2020-05-11;AV;30-39;232;319;551
2020-05-11;LE;30-39;426;700;1126
2020-05-11;SA;30-39;488;779;1267
2020-05-11;VA;30-39;616;918;1534
2020-05-11;ZA;30-39;104;164;268
2020-05-11;AV;40-49;336;493;829
2020-05-11;LE;40-49;652;1030;1682
2020-05-11;VA;40-49;870;1299;2169
2020-05-11;CyL;40-49;4328;6394;10722
2020-05-11;BU;50-59;649;960;1609
2020-05-11;SA;50-59;762;1233;1995
2020-05-11;SE;50-59;523;808;1331
2020-05-11;BU;60-69;464;541;1005
2020-05-11;PA;60-69;222;235;457
2020-05-11;SE;60-69;441;477;918
2020-05-11;CyL;60-69;3562;4234;7796
2020-05-11;BU;70-79;357;324;681
2020-05-11;PA;70-79;154;162;316
2020-05-11;SA;70-79;422;452;874
2020-05-11;SE;70-79;318;267;585
2020-05-11;VA;70-79;471;494;965
2020-05-11;CyL;70-79;2718;2613;5331
2020-05-11;AV;>80;356;559;915
2020-05-11;BU;>80;500;861;1361
2020-05-11;SA;>80;671;1156;1827
2020-05-11;SE;>80;531;816;1347
2020-05-11;SO;>80;330;600;930
2020-05-10;SE;0-9;100;84;184
2020-05-10;ZA;0-9;160;152;312
2020-05-10;CyL;0-9;1442;1271;2713
2020-05-10;BU;10-19;144;159;303
2020-05-10;PA;10-19;65;48;113
2020-05-10;VA;10-19;206;214;420
2020-05-10;CyL;10-19;931;935;1866
2020-05-10;LE;20-29;243;347;590
2020-05-10;ZA;20-29;56;85;141
2020-05-10;BU;30-39;517;679;1196
2020-05-10;PA;30-39;187;252;439
2020-05-10;SA;30-39;482;776;1258
2020-05-10;SO;30-39;137;215;352
2020-05-10;CyL;30-39;2937;4358;7295
2020-05-10;LE;40-49;644;1031;1675
2020-05-10;SA;40-49;641;991;1632
2020-05-10;ZA;40-49;159;250;409
2020-05-10;CyL;40-49;4265;6317;10582
2020-05-10;BU;50-59;639;943;1582
2020-05-10;SE;50-59;518;792;1310
2020-05-10;AV;60-69;292;344;636
2020-05-10;PA;60-69;220;233;453
2020-05-10;ZA;60-69;166;172;338
2020-05-10;AV;70-79;228;238;466
2020-05-10;LE;70-79;505;441;946
2020-05-10;SE;70-79;318;266;584
2020-05-10;VA;70-79;467;490;957
2020-05-10;BU;>80;499;853;1352
2020-05-10;SE;>80;532;815;1347
2020-05-10;ZA;>80;179;268;447
2020-05-10;CyL;>80;3971;6964;10935
2020-05-10;AV;0-9;105;89;194
2020-05-10;LE;0-9;204;187;391
2020-05-10;SA;0-9;243;267;510
2020-05-10;VA;0-9;341;292;633
2020-05-10;AV;10-19;85;63;148
2020-05-10;LE;10-19;126;137;263
2020-05-10;SA;10-19;153;159;312
2020-05-10;ZA;10-19;52;58;110
2020-05-10;BU;20-29;291;385;676
2020-05-10;PA;20-29;123;135;258
2020-05-10;CyL;20-29;1719;2457;4176
2020-05-10;AV;30-39;231;319;550
2020-05-10;LE;30-39;418;695;1113
2020-05-10;SE;30-39;248;354;602
2020-05-10;VA;30-39;616;905;1521
2020-05-10;ZA;30-39;101;163;264
2020-05-10;PA;40-49;289;356;645
2020-05-10;SE;40-49;409;587;996
2020-05-10;LE;50-59;657;980;1637
2020-05-10;PA;50-59;255;377;632
2020-05-10;SA;50-59;746;1215;1961
2020-05-10;SO;50-59;274;421;695
2020-05-10;CyL;50-59;4285;6656;10941
2020-05-10;BU;60-69;464;532;996
2020-05-10;LE;60-69;559;703;1262
2020-05-10;SA;60-69;622;718;1340
2020-05-10;SE;60-69;439;471;910
2020-05-10;VA;60-69;580;756;1336
2020-05-10;CyL;60-69;3530;4172;7702
2020-05-10;BU;70-79;354;322;676
2020-05-10;PA;70-79;150;158;308
2020-05-10;SA;70-79;417;451;868
2020-05-10;CyL;70-79;2695;2592;5287
2020-05-10;AV;>80;355;553;908
2020-05-10;LE;>80;658;1180;1838
2020-05-10;SA;>80;670;1155;1825
2020-05-10;SO;>80;330;600;930
2020-05-10;BU;0-9;186;140;326
2020-05-10;PA;0-9;55;26;81
2020-05-10;SO;0-9;48;34;82
2020-05-10;SE;10-19;63;63;126
2020-05-10;SO;10-19;37;34;71
2020-05-10;AV;20-29;128;176;304
2020-05-10;SA;20-29;288;453;741
2020-05-10;SE;20-29;154;226;380
2020-05-10;SO;20-29;93;132;225
2020-05-10;VA;20-29;343;518;861
2020-05-10;AV;40-49;333;484;817
2020-05-10;BU;40-49;718;979;1697
2020-05-10;SO;40-49;212;350;562
2020-05-10;VA;40-49;860;1289;2149
2020-05-10;AV;50-59;316;497;813
2020-05-10;VA;50-59;711;1155;1866
2020-05-10;ZA;50-59;169;276;445
2020-05-10;SO;60-69;188;243;431
2020-05-10;SO;70-79;144;118;262
2020-05-10;ZA;70-79;112;108;220
2020-05-10;PA;>80;189;380;569
2020-05-10;VA;>80;559;1160;1719
2020-05-09;BU;0-9;186;140;326
2020-05-09;SO;0-9;48;34;82
2020-05-09;VA;0-9;340;292;632
2020-05-09;BU;10-19;143;159;302
2020-05-09;PA;10-19;64;48;112
2020-05-09;LE;20-29;242;348;590
2020-05-09;SA;20-29;287;453;740
2020-05-09;SO;20-29;93;132;225
2020-05-09;BU;30-39;517;677;1194
2020-05-09;SA;30-39;481;776;1257
2020-05-09;ZA;30-39;101;163;264
2020-05-09;SE;40-49;410;587;997
2020-05-09;VA;40-49;860;1284;2144
2020-05-09;ZA;40-49;159;250;409
2020-05-09;LE;50-59;654;976;1630
2020-05-09;PA;50-59;254;376;630
2020-05-09;SA;50-59;745;1210;1955
2020-05-09;VA;50-59;711;1153;1864
2020-05-09;BU;60-69;464;534;998
2020-05-09;SE;60-69;438;471;909
2020-05-09;VA;60-69;580;755;1335
2020-05-09;CyL;60-69;3526;4170;7696
2020-05-09;BU;70-79;352;321;673
2020-05-09;LE;70-79;505;438;943
2020-05-09;PA;70-79;147;158;305
2020-05-09;VA;70-79;467;490;957
2020-05-09;CyL;70-79;2686;2586;5272
2020-05-09;ZA;>80;174;251;425
2020-05-09;AV;0-9;105;89;194
2020-05-09;LE;0-9;204;186;390
2020-05-09;CyL;0-9;1440;1270;2710
2020-05-09;ZA;10-19;52;58;110
2020-05-09;PA;20-29;123;133;256
2020-05-09;SE;20-29;153;227;380
2020-05-09;VA;20-29;342;517;859
2020-05-09;SO;30-39;136;213;349
2020-05-09;VA;30-39;614;907;1521
2020-05-09;CyL;30-39;2928;4351;7279
2020-05-09;BU;40-49;717;977;1694
2020-05-09;CyL;40-49;4263;6301;10564
2020-05-09;SE;50-59;517;792;1309
2020-05-09;ZA;50-59;169;276;445
2020-05-09;CyL;50-59;4279;6637;10916
2020-05-09;AV;60-69;291;344;635
2020-05-09;SA;60-69;620;716;1336
2020-05-09;SO;60-69;188;242;430
2020-05-09;ZA;60-69;165;172;337
2020-05-09;SA;70-79;417;452;869
2020-05-09;SE;70-79;317;265;582
2020-05-09;ZA;70-79;109;106;215
2020-05-09;SA;>80;670;1151;1821
2020-05-09;SO;>80;330;600;930
2020-05-09;VA;>80;559;1159;1718
2020-05-09;PA;0-9;54;26;80
2020-05-09;SA;0-9;243;267;510
2020-05-09;SE;0-9;100;84;184
2020-05-09;ZA;0-9;160;152;312
2020-05-09;AV;10-19;85;63;148
2020-05-09;LE;10-19;126;137;263
2020-05-09;SA;10-19;152;159;311
2020-05-09;SE;10-19;63;63;126
2020-05-09;SO;10-19;37;34;71
2020-05-09;VA;10-19;206;214;420
2020-05-09;CyL;10-19;928;935;1863
2020-05-09;AV;20-29;129;172;301
2020-05-09;BU;20-29;291;385;676
2020-05-09;ZA;20-29;56;85;141
2020-05-09;CyL;20-29;1716;2452;4168
2020-05-09;AV;30-39;228;319;547
2020-05-09;LE;30-39;415;693;1108
2020-05-09;PA;30-39;187;253;440
2020-05-09;SE;30-39;249;350;599
2020-05-09;AV;40-49;333;481;814
2020-05-09;LE;40-49;644;1028;1672
2020-05-09;PA;40-49;289;356;645
2020-05-09;SA;40-49;641;990;1631
2020-05-09;SO;40-49;210;348;558
2020-05-09;AV;50-59;315;496;811
2020-05-09;BU;50-59;640;941;1581
2020-05-09;SO;50-59;274;417;691
2020-05-09;LE;60-69;560;704;1264
2020-05-09;PA;60-69;220;232;452
2020-05-09;AV;70-79;228;238;466
2020-05-09;SO;70-79;144;118;262
2020-05-09;AV;>80;354;551;905
2020-05-09;BU;>80;496;852;1348
2020-05-09;LE;>80;657;1179;1836
2020-05-09;PA;>80;188;378;566
2020-05-09;SE;>80;519;804;1323
2020-05-09;CyL;>80;3947;6925;10872
2020-05-08;SE;0-9;100;83;183
2020-05-08;SO;0-9;48;34;82
2020-05-08;VA;0-9;340;292;632
2020-05-08;ZA;0-9;161;152;313
2020-05-08;PA;10-19;63;47;110
2020-05-08;SA;10-19;149;159;308
2020-05-08;AV;20-29;130;172;302
2020-05-08;BU;20-29;291;382;673
2020-05-08;PA;20-29;122;134;256
2020-05-08;SE;20-29;153;227;380
2020-05-08;ZA;20-29;56;85;141
2020-05-08;LE;30-39;412;687;1099
2020-05-08;SA;30-39;476;769;1245
2020-05-08;SO;30-39;134;211;345
2020-05-08;PA;40-49;288;352;640
2020-05-08;AV;50-59;315;492;807
2020-05-08;ZA;50-59;169;272;441
2020-05-08;CyL;50-59;4265;6604;10869
2020-05-08;AV;60-69;291;341;632
2020-05-08;BU;60-69;463;533;996
2020-05-08;LE;60-69;557;702;1259
2020-05-08;PA;60-69;219;232;451
2020-05-08;ZA;60-69;165;171;336
2020-05-08;SE;70-79;317;265;582
2020-05-08;VA;70-79;467;488;955
2020-05-08;SE;>80;520;802;1322
2020-05-08;VA;>80;558;1158;1716
2020-05-08;PA;0-9;53;25;78
2020-05-08;SA;0-9;244;267;511
2020-05-08;CyL;0-9;1441;1268;2709
2020-05-08;BU;10-19;143;159;302
2020-05-08;LE;10-19;125;137;262
2020-05-08;SE;10-19;62;63;125
2020-05-08;SO;10-19;37;34;71
2020-05-08;VA;10-19;206;213;419
2020-05-08;CyL;10-19;922;933;1855
2020-05-08;LE;20-29;242;346;588
2020-05-08;SA;20-29;287;449;736
2020-05-08;SO;20-29;92;132;224
2020-05-08;CyL;20-29;1715;2442;4157
2020-05-08;BU;30-39;516;677;1193
2020-05-08;VA;30-39;610;905;1515
2020-05-08;ZA;30-39;101;163;264
2020-05-08;CyL;30-39;2913;4328;7241
2020-05-08;VA;40-49;859;1283;2142
2020-05-08;ZA;40-49;159;248;407
2020-05-08;CyL;40-49;4256;6278;10534
2020-05-08;LE;50-59;650;972;1622
2020-05-08;SE;50-59;516;787;1303
2020-05-08;SO;50-59;271;410;681
2020-05-08;SA;60-69;619;714;1333
2020-05-08;SO;60-69;188;242;430
2020-05-08;VA;60-69;579;756;1335
2020-05-08;AV;70-79;228;237;465
2020-05-08;SA;70-79;415;452;867
2020-05-08;SO;70-79;145;118;263
2020-05-08;AV;>80;351;550;901
2020-05-08;LE;>80;656;1178;1834
2020-05-08;SO;>80;330;598;928
2020-05-08;ZA;>80;170;246;416
2020-05-08;AV;0-9;105;89;194
2020-05-08;BU;0-9;186;140;326
2020-05-08;LE;0-9;204;186;390
2020-05-08;AV;10-19;84;63;147
2020-05-08;ZA;10-19;53;58;111
2020-05-08;VA;20-29;342;515;857
2020-05-08;AV;30-39;229;319;548
2020-05-08;PA;30-39;187;253;440
2020-05-08;SE;30-39;248;344;592
2020-05-08;AV;40-49;332;480;812
2020-05-08;BU;40-49;717;977;1694
2020-05-08;LE;40-49;646;1026;1672
2020-05-08;SA;40-49;637;982;1619
2020-05-08;SE;40-49;409;583;992
2020-05-08;SO;40-49;209;347;556
2020-05-08;BU;50-59;639;940;1579
2020-05-08;PA;50-59;253;375;628
2020-05-08;SA;50-59;741;1204;1945
2020-05-08;VA;50-59;711;1152;1863
2020-05-08;SE;60-69;436;468;904
2020-05-08;CyL;60-69;3517;4159;7676
2020-05-08;BU;70-79;352;321;673
2020-05-08;LE;70-79;505;436;941
2020-05-08;PA;70-79;147;157;304
2020-05-08;ZA;70-79;110;105;215
2020-05-08;CyL;70-79;2686;2579;5265
2020-05-08;BU;>80;495;850;1345
2020-05-08;PA;>80;187;375;562
2020-05-08;SA;>80;666;1145;1811
2020-05-08;CyL;>80;3933;6902;10835
2020-05-07;AV;0-9;104;85;189
2020-05-07;BU;0-9;184;139;323
2020-05-07;PA;0-9;52;25;77
2020-05-07;VA;0-9;340;291;631
2020-05-07;CyL;0-9;1429;1252;2681
2020-05-07;SA;10-19;147;158;305
2020-05-07;CyL;10-19;903;917;1820
2020-05-07;AV;20-29;128;170;298
2020-05-07;BU;20-29;283;380;663
2020-05-07;PA;20-29;120;131;251
2020-05-07;ZA;20-29;55;80;135
2020-05-07;AV;30-39;226;316;542
2020-05-07;SA;30-39;472;764;1236
2020-05-07;SE;30-39;243;339;582
2020-05-07;ZA;30-39;98;159;257
2020-05-07;SA;40-49;629;962;1591
2020-05-07;AV;50-59;313;480;793
2020-05-07;LE;50-59;646;965;1611
2020-05-07;SE;50-59;509;773;1282
2020-05-07;SO;50-59;257;407;664
2020-05-07;ZA;50-59;167;270;437
2020-05-07;AV;60-69;285;331;616
2020-05-07;LE;60-69;554;692;1246
2020-05-07;SE;60-69;431;459;890
2020-05-07;VA;60-69;569;742;1311
2020-05-07;BU;70-79;352;319;671
2020-05-07;PA;70-79;146;154;300
2020-05-07;SA;70-79;410;446;856
2020-05-07;SO;70-79;143;118;261
2020-05-07;VA;70-79;466;481;947
2020-05-07;AV;>80;348;543;891
2020-05-07;BU;>80;492;838;1330
2020-05-07;BU;10-19;143;157;300
2020-05-07;LE;10-19;123;134;257
2020-05-07;ZA;10-19;50;56;106
2020-05-07;LE;20-29;242;346;588
2020-05-07;SA;20-29;282;444;726
2020-05-07;SO;20-29;89;132;221
2020-05-07;VA;20-29;338;508;846
2020-05-07;LE;30-39;409;685;1094
2020-05-07;PA;30-39;189;249;438
2020-05-07;AV;40-49;323;473;796
2020-05-07;PA;40-49;285;350;635
2020-05-07;SE;40-49;405;578;983
2020-05-07;SO;40-49;205;340;545
2020-05-07;VA;40-49;852;1264;2116
2020-05-07;BU;50-59;635;932;1567
2020-05-07;BU;60-69;459;525;984
2020-05-07;SA;60-69;613;702;1315
2020-05-07;SO;60-69;185;241;426
2020-05-07;ZA;60-69;160;162;322
2020-05-07;SE;70-79;315;260;575
2020-05-07;CyL;70-79;2670;2547;5217
2020-05-07;PA;>80;186;372;558
2020-05-07;SA;>80;663;1135;1798
2020-05-07;VA;>80;558;1150;1708
2020-05-07;LE;0-9;204;184;388
2020-05-07;SA;0-9;238;264;502
2020-05-07;SE;0-9;99;82;181
2020-05-07;SO;0-9;48;33;81
2020-05-07;ZA;0-9;160;149;309
2020-05-07;AV;10-19;82;62;144
2020-05-07;PA;10-19;62;46;108
2020-05-07;SE;10-19;60;63;123
2020-05-07;SO;10-19;36;34;70
2020-05-07;VA;10-19;200;207;407
2020-05-07;SE;20-29;151;224;375
2020-05-07;CyL;20-29;1688;2415;4103
2020-05-07;BU;30-39;514;669;1183
2020-05-07;SO;30-39;132;209;341
2020-05-07;VA;30-39;599;895;1494
2020-05-07;CyL;30-39;2882;4285;7167
2020-05-07;BU;40-49;704;962;1666
2020-05-07;LE;40-49;637;1013;1650
2020-05-07;ZA;40-49;159;243;402
2020-05-07;CyL;40-49;4199;6185;10384
2020-05-07;PA;50-59;248;369;617
2020-05-07;SA;50-59;737;1181;1918
2020-05-07;VA;50-59;702;1131;1833
2020-05-07;CyL;50-59;4214;6508;10722
2020-05-07;PA;60-69;215;227;442
2020-05-07;CyL;60-69;3471;4081;7552
2020-05-07;AV;70-79;224;236;460
2020-05-07;LE;70-79;504;431;935
2020-05-07;ZA;70-79;110;102;212
2020-05-07;LE;>80;652;1174;1826
2020-05-07;SE;>80;521;798;1319
2020-05-07;SO;>80;329;595;924
2020-05-07;ZA;>80;170;243;413
2020-05-07;CyL;>80;3919;6848;10767
2020-05-06;AV;0-9;103;86;189
2020-05-06;BU;0-9;182;139;321
2020-05-06;AV;10-19;81;63;144
2020-05-06;LE;10-19;121;131;252
2020-05-06;SA;10-19;146;156;302
2020-05-06;VA;10-19;202;207;409
2020-05-06;CyL;10-19;896;906;1802
2020-05-06;SA;20-29;279;442;721
2020-05-06;PA;30-39;186;247;433
2020-05-06;ZA;30-39;94;150;244
2020-05-06;BU;40-49;700;955;1655
2020-05-06;LE;40-49;632;1005;1637
2020-05-06;CyL;40-49;4158;6106;10264
2020-05-06;BU;50-59;628;913;1541
2020-05-06;PA;50-59;244;366;610
2020-05-06;SA;50-59;722;1156;1878
2020-05-06;VA;50-59;693;1110;1803
2020-05-06;BU;60-69;454;517;971
2020-05-06;SO;60-69;182;236;418
2020-05-06;ZA;60-69;154;156;310
2020-05-06;AV;70-79;221;234;455
2020-05-06;BU;70-79;347;315;662
2020-05-06;LE;70-79;501;427;928
2020-05-06;SA;70-79;407;443;850
2020-05-06;SO;70-79;143;118;261
2020-05-06;VA;70-79;461;470;931
2020-05-06;LE;>80;651;1170;1821
2020-05-06;SE;>80;516;796;1312
2020-05-06;VA;>80;554;1138;1692
2020-05-06;CyL;>80;3893;6808;10701
2020-05-06;PA;0-9;51;25;76
2020-05-06;SE;0-9;98;81;179
2020-05-06;SO;0-9;47;32;79
2020-05-06;ZA;10-19;49;53;102
2020-05-06;AV;20-29;128;171;299
2020-05-06;LE;20-29;234;343;577
2020-05-06;PA;20-29;119;129;248
2020-05-06;SO;20-29;88;132;220
2020-05-06;VA;20-29;337;503;840
2020-05-06;ZA;20-29;57;80;137
2020-05-06;BU;30-39;508;661;1169
2020-05-06;SA;30-39;464;754;1218
2020-05-06;VA;30-39;593;884;1477
2020-05-06;CyL;30-39;2843;4232;7075
2020-05-06;AV;40-49;318;463;781
2020-05-06;PA;40-49;282;345;627
2020-05-06;SE;40-49;402;567;969
2020-05-06;SO;40-49;203;334;537
2020-05-06;VA;40-49;839;1246;2085
2020-05-06;AV;50-59;306;474;780
2020-05-06;ZA;50-59;158;264;422
2020-05-06;AV;60-69;283;326;609
2020-05-06;SA;60-69;612;691;1303
2020-05-06;SE;60-69;428;459;887
2020-05-06;SE;70-79;312;257;569
2020-05-06;CyL;70-79;2646;2517;5163
2020-05-06;AV;>80;348;540;888
2020-05-06;SO;>80;328;593;921
2020-05-06;LE;0-9;203;184;387
2020-05-06;SA;0-9;236;263;499
2020-05-06;VA;0-9;336;285;621
2020-05-06;ZA;0-9;158;149;307
2020-05-06;CyL;0-9;1414;1244;2658
2020-05-06;BU;10-19;142;156;298
2020-05-06;PA;10-19;62;46;108
2020-05-06;SE;10-19;57;61;118
2020-05-06;SO;10-19;36;33;69
2020-05-06;BU;20-29;285;375;660
2020-05-06;SE;20-29;149;225;374
2020-05-06;CyL;20-29;1676;2400;4076
2020-05-06;AV;30-39;224;311;535
2020-05-06;LE;30-39;404;684;1088
2020-05-06;SE;30-39;238;332;570
2020-05-06;SO;30-39;132;209;341
2020-05-06;SA;40-49;623;953;1576
2020-05-06;ZA;40-49;159;238;397
2020-05-06;LE;50-59;636;960;1596
2020-05-06;SE;50-59;497;750;1247
2020-05-06;SO;50-59;254;400;654
2020-05-06;CyL;50-59;4138;6393;10531
2020-05-06;LE;60-69;555;690;1245
2020-05-06;PA;60-69;212;222;434
2020-05-06;VA;60-69;561;731;1292
2020-05-06;CyL;60-69;3441;4028;7469
2020-05-06;PA;70-79;143;152;295
2020-05-06;ZA;70-79;111;101;212
2020-05-06;BU;>80;490;835;1325
2020-05-06;PA;>80;184;370;554
2020-05-06;SA;>80;660;1122;1782
2020-05-06;ZA;>80;162;244;406
2020-05-05;BU;0-9;180;139;319
2020-05-05;SA;0-9;236;262;498
2020-05-05;SE;0-9;96;81;177
2020-05-05;SO;0-9;47;32;79
2020-05-05;PA;10-19;62;45;107
2020-05-05;SO;10-19;34;32;66
2020-05-05;BU;20-29;282;370;652
2020-05-05;LE;20-29;231;340;571
2020-05-05;SE;20-29;148;221;369
2020-05-05;SO;30-39;128;205;333
2020-05-05;PA;40-49;279;342;621
2020-05-05;SO;40-49;200;330;530
2020-05-05;VA;40-49;826;1237;2063
2020-05-05;BU;50-59;621;908;1529
2020-05-05;PA;50-59;245;362;607
2020-05-05;ZA;50-59;149;247;396
2020-05-05;LE;60-69;548;678;1226
2020-05-05;PA;60-69;212;219;431
2020-05-05;CyL;60-69;3389;3963;7352
2020-05-05;AV;70-79;220;231;451
2020-05-05;LE;70-79;501;424;925
2020-05-05;SO;70-79;135;114;249
2020-05-05;ZA;70-79;99;89;188
2020-05-05;CyL;70-79;2600;2467;5067
2020-05-05;BU;>80;487;830;1317
2020-05-05;SA;>80;629;1028;1657
2020-05-05;SE;>80;512;793;1305
2020-05-05;SO;>80;325;586;911
2020-05-05;AV;0-9;102;85;187
2020-05-05;LE;0-9;203;182;385
2020-05-05;AV;10-19;80;63;143
2020-05-05;LE;10-19;120;129;249
2020-05-05;ZA;10-19;47;51;98
2020-05-05;AV;20-29;127;169;296
2020-05-05;PA;20-29;118;126;244
2020-05-05;VA;20-29;339;490;829
2020-05-05;ZA;20-29;54;77;131
2020-05-05;AV;30-39;220;306;526
2020-05-05;PA;30-39;183;245;428
2020-05-05;SA;30-39;462;745;1207
2020-05-05;SE;30-39;235;327;562
2020-05-05;VA;30-39;590;872;1462
2020-05-05;CyL;30-39;2812;4189;7001
2020-05-05;LE;40-49;627;1002;1629
2020-05-05;ZA;40-49;147;233;380
2020-05-05;CyL;40-49;4106;6060;10166
2020-05-05;LE;50-59;633;961;1594
2020-05-05;SE;50-59;489;748;1237
2020-05-05;VA;50-59;686;1085;1771
2020-05-05;AV;60-69;280;318;598
2020-05-05;BU;60-69;448;519;967
2020-05-05;SE;60-69;425;454;879
2020-05-05;VA;60-69;553;714;1267
2020-05-05;VA;70-79;454;461;915
2020-05-05;LE;>80;645;1161;1806
2020-05-05;VA;>80;549;1127;1676
2020-05-05;ZA;>80;150;196;346
2020-05-05;PA;0-9;50;22;72
2020-05-05;VA;0-9;328;277;605
2020-05-05;ZA;0-9;156;149;305
2020-05-05;CyL;0-9;1398;1229;2627
2020-05-05;BU;10-19;140;155;295
2020-05-05;SA;10-19;146;153;299
2020-05-05;SE;10-19;60;60;120
2020-05-05;VA;10-19;197;204;401
2020-05-05;CyL;10-19;886;892;1778
2020-05-05;SA;20-29;276;437;713
2020-05-05;SO;20-29;88;129;217
2020-05-05;CyL;20-29;1663;2359;4022
2020-05-05;BU;30-39;503;654;1157
2020-05-05;LE;30-39;400;687;1087
2020-05-05;ZA;30-39;91;148;239
2020-05-05;AV;40-49;317;463;780
2020-05-05;BU;40-49;690;946;1636
2020-05-05;SA;40-49;619;943;1562
2020-05-05;SE;40-49;401;564;965
2020-05-05;AV;50-59;305;469;774
2020-05-05;SA;50-59;716;1137;1853
2020-05-05;SO;50-59;249;386;635
2020-05-05;CyL;50-59;4093;6303;10396
2020-05-05;SA;60-69;604;686;1290
2020-05-05;SO;60-69;179;226;405
2020-05-05;ZA;60-69;140;149;289
2020-05-05;BU;70-79;343;312;655
2020-05-05;PA;70-79;139;149;288
2020-05-05;SA;70-79;401;434;835
2020-05-05;SE;70-79;308;253;561
2020-05-05;AV;>80;343;536;879
2020-05-05;PA;>80;184;369;553
2020-05-05;CyL;>80;3824;6626;10450
2020-05-04;BU;0-9;178;137;315
2020-05-04;PA;0-9;49;22;71
2020-05-04;SE;0-9;96;79;175
2020-05-04;SO;0-9;46;32;78
2020-05-04;CyL;0-9;1390;1218;2608
2020-05-04;BU;10-19;138;150;288
2020-05-04;PA;10-19;62;45;107
2020-05-04;BU;20-29;277;366;643
2020-05-04;SE;20-29;146;217;363
2020-05-04;SO;20-29;85;119;204
2020-05-04;BU;30-39;499;645;1144
2020-05-04;VA;30-39;584;859;1443
2020-05-04;BU;40-49;684;941;1625
2020-05-04;SA;40-49;616;927;1543
2020-05-04;ZA;40-49;146;228;374
2020-05-04;AV;50-59;304;461;765
2020-05-04;BU;50-59;615;900;1515
2020-05-04;SO;50-59;242;375;617
2020-05-04;VA;50-59;685;1060;1745
2020-05-04;AV;60-69;274;311;585
2020-05-04;PA;60-69;209;216;425
2020-05-04;ZA;60-69;138;150;288
2020-05-04;CyL;60-69;3345;3908;7253
2020-05-04;AV;70-79;219;227;446
2020-05-04;BU;70-79;338;309;647
2020-05-04;SO;70-79;134;112;246
2020-05-04;VA;70-79;452;458;910
2020-05-04;ZA;70-79;98;88;186
2020-05-04;CyL;70-79;2580;2440;5020
2020-05-04;AV;>80;343;534;877
2020-05-04;VA;>80;543;1126;1669
2020-05-04;CyL;>80;3794;6586;10380
2020-05-04;LE;0-9;203;182;385
2020-05-04;ZA;0-9;155;145;300
2020-05-04;AV;10-19;78;63;141
2020-05-04;VA;10-19;197;201;398
2020-05-04;CyL;10-19;877;874;1751
2020-05-04;LE;20-29;227;344;571
2020-05-04;SA;20-29;272;435;707
2020-05-04;ZA;20-29;52;74;126
2020-05-04;CyL;20-29;1637;2331;3968
2020-05-04;AV;30-39;216;306;522
2020-05-04;LE;30-39;396;678;1074
2020-05-04;SA;30-39;459;737;1196
2020-05-04;SE;30-39;234;323;557
2020-05-04;ZA;30-39;89;148;237
2020-05-04;CyL;30-39;2785;4143;6928
2020-05-04;SE;40-49;397;556;953
2020-05-04;VA;40-49;814;1219;2033
2020-05-04;CyL;40-49;4065;5992;10057
2020-05-04;LE;50-59;628;952;1580
2020-05-04;PA;50-59;243;361;604
2020-05-04;ZA;50-59;146;242;388
2020-05-04;LE;60-69;547;670;1217
2020-05-04;SE;60-69;415;445;860
2020-05-04;LE;70-79;500;421;921
2020-05-04;SE;70-79;305;249;554
2020-05-04;BU;>80;483;832;1315
2020-05-04;SO;>80;324;585;909
2020-05-04;AV;0-9;102;84;186
2020-05-04;SA;0-9;236;260;496
2020-05-04;VA;0-9;325;277;602
2020-05-04;LE;10-19;118;125;243
2020-05-04;SA;10-19;146;152;298
2020-05-04;SE;10-19;59;57;116
2020-05-04;SO;10-19;33;32;65
2020-05-04;ZA;10-19;46;49;95
2020-05-04;AV;20-29;126;167;293
2020-05-04;PA;20-29;118;124;242
2020-05-04;VA;20-29;334;485;819
2020-05-04;PA;30-39;180;244;424
2020-05-04;SO;30-39;128;203;331
2020-05-04;AV;40-49;319;460;779
2020-05-04;LE;40-49;620;994;1614
2020-05-04;PA;40-49;271;344;615
2020-05-04;SO;40-49;198;323;521
2020-05-04;SA;50-59;715;1122;1837
2020-05-04;SE;50-59;480;734;1214
2020-05-04;CyL;50-59;4058;6207;10265
2020-05-04;BU;60-69;452;516;968
2020-05-04;SA;60-69;598;676;1274
2020-05-04;SO;60-69;176;221;397
2020-05-04;VA;60-69;536;703;1239
2020-05-04;PA;70-79;137;145;282
2020-05-04;SA;70-79;397;431;828
2020-05-04;LE;>80;641;1156;1797
2020-05-04;PA;>80;182;368;550
2020-05-04;SA;>80;626;1011;1637
2020-05-04;SE;>80;509;788;1297
2020-05-04;ZA;>80;143;186;329
2020-05-03;SA;0-9;234;258;492
2020-05-03;SE;0-9;91;77;168
2020-05-03;SO;0-9;44;31;75
2020-05-03;CyL;0-9;1362;1204;2566
2020-05-03;PA;10-19;61;44;105
2020-05-03;ZA;10-19;43;47;90
2020-05-03;BU;20-29;273;371;644
2020-05-03;LE;20-29;225;333;558
2020-05-03;PA;20-29;115;122;237
2020-05-03;PA;30-39;178;241;419
2020-05-03;SE;30-39;235;314;549
2020-05-03;BU;40-49;676;926;1602
2020-05-03;LE;40-49;612;986;1598
2020-05-03;SE;40-49;395;555;950
2020-05-03;SO;40-49;195;314;509
2020-05-03;CyL;40-49;4010;5901;9911
2020-05-03;AV;50-59;297;448;745
2020-05-03;LE;50-59;622;937;1559
2020-05-03;BU;60-69;451;508;959
2020-05-03;SE;60-69;412;448;860
2020-05-03;CyL;60-69;3313;3841;7154
2020-05-03;PA;70-79;135;143;278
2020-05-03;SE;70-79;303;249;552
2020-05-03;CyL;70-79;2558;2419;4977
2020-05-03;LE;>80;637;1153;1790
2020-05-03;LE;0-9;202;181;383
2020-05-03;PA;0-9;48;22;70
2020-05-03;ZA;0-9;151;142;293
2020-05-03;BU;10-19;138;147;285
2020-05-03;LE;10-19;117;124;241
2020-05-03;SE;10-19;56;51;107
2020-05-03;SO;10-19;33;32;65
2020-05-03;VA;10-19;188;196;384
2020-05-03;CyL;10-19;857;852;1709
2020-05-03;VA;20-29;332;475;807
2020-05-03;ZA;20-29;49;71;120
2020-05-03;AV;30-39;215;303;518
2020-05-03;LE;30-39;393;676;1069
2020-05-03;SA;30-39;459;725;1184
2020-05-03;ZA;30-39;87;145;232
2020-05-03;AV;40-49;314;452;766
2020-05-03;SA;40-49;605;909;1514
2020-05-03;ZA;40-49;144;222;366
2020-05-03;SO;50-59;237;361;598
2020-05-03;VA;50-59;674;1041;1715
2020-05-03;CyL;50-59;4012;6092;10104
2020-05-03;SO;60-69;176;213;389
2020-05-03;BU;70-79;337;307;644
2020-05-03;SO;70-79;133;111;244
2020-05-03;ZA;70-79;96;87;183
2020-05-03;AV;>80;342;535;877
2020-05-03;BU;>80;476;829;1305
2020-05-03;SA;>80;620;980;1600
2020-05-03;SO;>80;323;584;907
2020-05-03;VA;>80;541;1114;1655
2020-05-03;CyL;>80;3763;6531;10294
2020-05-03;AV;0-9;102;84;186
2020-05-03;BU;0-9;176;135;311
2020-05-03;VA;0-9;314;274;588
2020-05-03;AV;10-19;77;63;140
2020-05-03;SA;10-19;144;148;292
2020-05-03;AV;20-29;125;162;287
2020-05-03;SA;20-29;270;427;697
2020-05-03;SE;20-29;144;214;358
2020-05-03;SO;20-29;81;115;196
2020-05-03;CyL;20-29;1614;2290;3904
2020-05-03;BU;30-39;502;645;1147
2020-05-03;SO;30-39;127;191;318
2020-05-03;VA;30-39;579;843;1422
2020-05-03;CyL;30-39;2775;4083;6858
2020-05-03;PA;40-49;268;341;609
2020-05-03;VA;40-49;801;1196;1997
2020-05-03;BU;50-59;615;889;1504
2020-05-03;PA;50-59;239;357;596
2020-05-03;SA;50-59;710;1101;1811
2020-05-03;SE;50-59;477;724;1201
2020-05-03;ZA;50-59;141;234;375
2020-05-03;AV;60-69;269;305;574
2020-05-03;LE;60-69;541;659;1200
2020-05-03;PA;60-69;204;213;417
2020-05-03;SA;60-69;595;664;1259
2020-05-03;VA;60-69;529;687;1216
2020-05-03;ZA;60-69;136;144;280
2020-05-03;AV;70-79;216;226;442
2020-05-03;LE;70-79;495;421;916
2020-05-03;SA;70-79;396;422;818
2020-05-03;VA;70-79;447;453;900
2020-05-03;PA;>80;180;369;549
2020-05-03;SE;>80;504;783;1287
2020-05-03;ZA;>80;140;184;324
2020-05-02;AV;0-9;102;84;186
2020-05-02;VA;0-9;314;274;588
2020-05-02;CyL;0-9;1360;1202;2562
2020-05-02;AV;10-19;77;63;140
2020-05-02;CyL;10-19;847;846;1693
2020-05-02;PA;20-29;115;122;237
2020-05-02;VA;20-29;330;472;802
2020-05-02;AV;30-39;214;304;518
2020-05-02;SA;30-39;458;725;1183
2020-05-02;ZA;30-39;87;145;232
2020-05-02;CyL;30-39;2769;4075;6844
2020-05-02;BU;40-49;675;927;1602
2020-05-02;SA;40-49;604;907;1511
2020-05-02;ZA;40-49;144;221;365
2020-05-02;AV;50-59;296;448;744
2020-05-02;BU;50-59;614;888;1502
2020-05-02;SE;50-59;475;722;1197
2020-05-02;VA;50-59;673;1038;1711
2020-05-02;ZA;50-59;142;234;376
2020-05-02;BU;60-69;450;510;960
2020-05-02;PA;60-69;204;212;416
2020-05-02;CyL;60-69;3305;3838;7143
2020-05-02;BU;70-79;337;306;643
2020-05-02;PA;70-79;135;142;277
2020-05-02;BU;>80;473;828;1301
2020-05-02;LE;>80;636;1152;1788
2020-05-02;SE;>80;504;783;1287
2020-05-02;VA;>80;541;1114;1655
2020-05-02;LE;0-9;201;181;382
2020-05-02;SA;0-9;234;258;492
2020-05-02;LE;10-19;112;122;234
2020-05-02;SO;10-19;31;31;62
2020-05-02;VA;10-19;187;196;383
2020-05-02;ZA;10-19;43;47;90
2020-05-02;AV;20-29;125;163;288
2020-05-02;BU;20-29;273;369;642
2020-05-02;SE;20-29;142;213;355
2020-05-02;SO;20-29;81;110;191
2020-05-02;CyL;20-29;1609;2279;3888
2020-05-02;SE;30-39;233;314;547
2020-05-02;LE;40-49;611;982;1593
2020-05-02;LE;50-59;620;935;1555
2020-05-02;CyL;50-59;4002;6077;10079
2020-05-02;SE;60-69;413;443;856
2020-05-02;VA;60-69;529;687;1216
2020-05-02;AV;70-79;216;226;442
2020-05-02;SA;70-79;397;422;819
2020-05-02;SE;70-79;302;247;549
2020-05-02;VA;70-79;447;455;902
2020-05-02;ZA;70-79;96;87;183
2020-05-02;AV;>80;340;528;868
2020-05-02;PA;>80;178;368;546
2020-05-02;SA;>80;621;976;1597
2020-05-02;SO;>80;322;583;905
2020-05-02;CyL;>80;3754;6514;10268
2020-05-02;BU;0-9;175;135;310
2020-05-02;PA;0-9;48;21;69
2020-05-02;SE;0-9;90;76;166
2020-05-02;SO;0-9;44;31;75
2020-05-02;ZA;0-9;152;142;294
2020-05-02;BU;10-19;138;146;284
2020-05-02;PA;10-19;61;44;105
2020-05-02;SA;10-19;144;147;291
2020-05-02;SE;10-19;54;50;104
2020-05-02;LE;20-29;225;332;557
2020-05-02;SA;20-29;269;427;696
2020-05-02;ZA;20-29;49;71;120
2020-05-02;BU;30-39;500;644;1144
2020-05-02;LE;30-39;393;673;1066
2020-05-02;PA;30-39;178;239;417
2020-05-02;SO;30-39;127;189;316
2020-05-02;VA;30-39;579;842;1421
2020-05-02;AV;40-49;313;451;764
2020-05-02;PA;40-49;268;339;607
2020-05-02;SE;40-49;392;550;942
2020-05-02;SO;40-49;195;307;502
2020-05-02;VA;40-49;799;1194;1993
2020-05-02;CyL;40-49;4001;5878;9879
2020-05-02;PA;50-59;238;356;594
2020-05-02;SA;50-59;708;1100;1808
2020-05-02;SO;50-59;236;356;592
2020-05-02;AV;60-69;268;306;574
2020-05-02;LE;60-69;537;659;1196
2020-05-02;SA;60-69;593;664;1257
2020-05-02;SO;60-69;176;213;389
2020-05-02;ZA;60-69;135;144;279
2020-05-02;LE;70-79;491;420;911
2020-05-02;SO;70-79;134;110;244
2020-05-02;CyL;70-79;2555;2415;4970
2020-05-02;ZA;>80;139;182;321
2020-05-01;BU;0-9;174;135;309
2020-05-01;SA;0-9;234;255;489
2020-05-01;ZA;0-9;152;142;294
2020-05-01;AV;10-19;77;63;140
2020-05-01;PA;10-19;60;44;104
2020-05-01;SE;10-19;54;50;104
2020-05-01;SO;10-19;29;29;58
2020-05-01;VA;10-19;187;195;382
2020-05-01;ZA;10-19;43;47;90
2020-05-01;CyL;10-19;841;840;1681
2020-05-01;AV;20-29;125;163;288
2020-05-01;SA;20-29;268;425;693
2020-05-01;VA;20-29;331;473;804
2020-05-01;PA;30-39;178;239;417
2020-05-01;VA;30-39;578;843;1421
2020-05-01;CyL;30-39;2761;4068;6829
2020-05-01;AV;40-49;310;451;761
2020-05-01;SE;40-49;392;551;943
2020-05-01;SO;40-49;194;302;496
2020-05-01;VA;40-49;799;1194;1993
2020-05-01;CyL;40-49;3987;5863;9850
2020-05-01;LE;50-59;617;930;1547
2020-05-01;PA;50-59;238;354;592
2020-05-01;SO;50-59;231;351;582
2020-05-01;ZA;50-59;140;233;373
2020-05-01;AV;60-69;268;303;571
2020-05-01;PA;60-69;202;209;411
2020-05-01;SE;60-69;411;445;856
2020-05-01;SO;60-69;175;207;382
2020-05-01;VA;60-69;529;684;1213
2020-05-01;AV;70-79;216;224;440
2020-05-01;CyL;70-79;2547;2405;4952
2020-05-01;AV;>80;338;526;864
2020-05-01;BU;>80;471;825;1296
2020-05-01;LE;>80;635;1150;1785
2020-05-01;ZA;>80;136;182;318
2020-05-01;CyL;>80;3740;6499;10239
2020-05-01;AV;0-9;102;84;186
2020-05-01;PA;0-9;46;21;67
2020-05-01;SE;0-9;90;76;166
2020-05-01;SO;0-9;43;31;74
2020-05-01;CyL;0-9;1357;1199;2556
2020-05-01;LE;10-19;112;122;234
2020-05-01;SA;10-19;142;145;287
2020-05-01;BU;20-29;272;366;638
2020-05-01;PA;20-29;114;121;235
2020-05-01;SE;20-29;140;214;354
2020-05-01;SO;20-29;79;103;182
2020-05-01;ZA;20-29;49;70;119
2020-05-01;CyL;20-29;1602;2267;3869
2020-05-01;AV;30-39;213;304;517
2020-05-01;BU;30-39;499;644;1143
2020-05-01;LE;30-39;390;669;1059
2020-05-01;SE;30-39;234;312;546
2020-05-01;SO;30-39;125;187;312
2020-05-01;BU;40-49;673;924;1597
2020-05-01;SA;40-49;601;902;1503
2020-05-01;BU;50-59;609;884;1493
2020-05-01;SE;50-59;473;716;1189
2020-05-01;VA;50-59;673;1039;1712
2020-05-01;CyL;50-59;3980;6046;10026
2020-05-01;SA;60-69;590;659;1249
2020-05-01;ZA;60-69;135;145;280
2020-05-01;CyL;60-69;3296;3817;7113
2020-05-01;BU;70-79;336;306;642
2020-05-01;LE;70-79;490;418;908
2020-05-01;PA;70-79;135;142;277
2020-05-01;SE;70-79;301;246;547
2020-05-01;SO;70-79;132;108;240
2020-05-01;VA;70-79;446;454;900
2020-05-01;PA;>80;177;368;545
2020-05-01;SE;>80;501;781;1282
2020-05-01;LE;0-9;201;181;382
2020-05-01;VA;0-9;315;274;589
2020-05-01;BU;10-19;137;145;282
2020-05-01;LE;20-29;224;332;556
2020-05-01;SA;30-39;457;725;1182
2020-05-01;ZA;30-39;87;145;232
2020-05-01;LE;40-49;610;982;1592
2020-05-01;PA;40-49;265;337;602
2020-05-01;ZA;40-49;143;220;363
2020-05-01;AV;50-59;294;446;740
2020-05-01;SA;50-59;705;1093;1798
2020-05-01;BU;60-69;449;505;954
2020-05-01;LE;60-69;537;660;1197
2020-05-01;SA;70-79;396;420;816
2020-05-01;ZA;70-79;95;87;182
2020-05-01;SA;>80;620;973;1593
2020-05-01;SO;>80;321;580;901
2020-05-01;VA;>80;541;1114;1655
2020-04-30;AV;0-9;102;84;186
2020-04-30;BU;0-9;173;133;306
2020-04-30;PA;0-9;45;21;66
2020-04-30;SA;0-9;232;255;487
2020-04-30;SE;0-9;89;76;165
2020-04-30;PA;10-19;60;44;104
2020-04-30;SE;10-19;55;50;105
2020-04-30;VA;10-19;187;195;382
2020-04-30;ZA;10-19;42;47;89
2020-04-30;CyL;10-19;839;840;1679
2020-04-30;SE;20-29;140;214;354
2020-04-30;SO;20-29;78;101;179
2020-04-30;ZA;20-29;49;72;121
2020-04-30;SE;30-39;233;313;546
2020-04-30;SO;30-39;118;187;305
2020-04-30;VA;30-39;578;837;1415
2020-04-30;LE;40-49;604;979;1583
2020-04-30;PA;40-49;263;334;597
2020-04-30;SO;40-49;194;304;498
2020-04-30;PA;50-59;236;354;590
2020-04-30;SE;50-59;471;712;1183
2020-04-30;SO;50-59;225;348;573
2020-04-30;CyL;50-59;3961;6027;9988
2020-04-30;AV;60-69;268;301;569
2020-04-30;PA;60-69;202;209;411
2020-04-30;CyL;60-69;3285;3801;7086
2020-04-30;BU;70-79;335;304;639
2020-04-30;LE;70-79;488;417;905
2020-04-30;ZA;70-79;94;88;182
2020-04-30;AV;>80;337;523;860
2020-04-30;BU;>80;470;820;1290
2020-04-30;LE;>80;634;1148;1782
2020-04-30;SO;>80;319;579;898
2020-04-30;VA;>80;539;1112;1651
2020-04-30;SO;0-9;42;31;73
2020-04-30;CyL;0-9;1349;1197;2546
2020-04-30;LE;10-19;112;122;234
2020-04-30;SA;10-19;142;145;287
2020-04-30;SO;10-19;29;29;58
2020-04-30;AV;20-29;124;163;287
2020-04-30;LE;20-29;224;332;556
2020-04-30;PA;20-29;113;121;234
2020-04-30;SA;20-29;268;423;691
2020-04-30;VA;20-29;327;471;798
2020-04-30;BU;30-39;494;639;1133
2020-04-30;PA;30-39;176;238;414
2020-04-30;SA;30-39;455;722;1177
2020-04-30;CyL;30-39;2744;4054;6798
2020-04-30;AV;40-49;310;450;760
2020-04-30;SA;40-49;605;896;1501
2020-04-30;ZA;40-49;143;220;363
2020-04-30;AV;50-59;293;446;739
2020-04-30;BU;50-59;607;885;1492
2020-04-30;LE;50-59;613;927;1540
2020-04-30;SA;50-59;704;1089;1793
2020-04-30;VA;50-59;673;1036;1709
2020-04-30;ZA;50-59;139;230;369
2020-04-30;LE;60-69;537;658;1195
2020-04-30;SA;60-69;586;657;1243
2020-04-30;SE;60-69;411;442;853
2020-04-30;SO;60-69;173;206;379
2020-04-30;ZA;60-69;134;142;276
2020-04-30;PA;70-79;135;136;271
2020-04-30;SE;70-79;300;246;546
2020-04-30;CyL;70-79;2536;2391;4927
2020-04-30;PA;>80;175;360;535
2020-04-30;SE;>80;501;782;1283
2020-04-30;ZA;>80;136;181;317
2020-04-30;CyL;>80;3728;6463;10191
2020-04-30;LE;0-9;200;181;381
2020-04-30;VA;0-9;315;274;589
2020-04-30;ZA;0-9;151;142;293
2020-04-30;AV;10-19;76;63;139
2020-04-30;BU;10-19;136;145;281
2020-04-30;BU;20-29;271;364;635
2020-04-30;CyL;20-29;1594;2261;3855
2020-04-30;AV;30-39;213;302;515
2020-04-30;LE;30-39;389;670;1059
2020-04-30;ZA;30-39;88;146;234
2020-04-30;BU;40-49;668;925;1593
2020-04-30;SE;40-49;387;549;936
2020-04-30;VA;40-49;796;1189;1985
2020-04-30;CyL;40-49;3970;5846;9816
2020-04-30;BU;60-69;449;505;954
2020-04-30;VA;60-69;525;681;1206
2020-04-30;AV;70-79;214;223;437
2020-04-30;SA;70-79;394;418;812
2020-04-30;SO;70-79;131;108;239
2020-04-30;VA;70-79;445;451;896
2020-04-30;SA;>80;617;958;1575
2020-04-29;LE;0-9;198;182;380
2020-04-29;VA;0-9;307;267;574
2020-04-29;CyL;0-9;1329;1190;2519
2020-04-29;LE;10-19;110;121;231
2020-04-29;SA;10-19;141;146;287
2020-04-29;SO;10-19;29;29;58
2020-04-29;AV;20-29;122;163;285
2020-04-29;PA;20-29;109;121;230
2020-04-29;SE;20-29;140;211;351
2020-04-29;VA;20-29;322;459;781
2020-04-29;LE;30-39;390;662;1052
2020-04-29;PA;30-39;175;233;408
2020-04-29;SA;30-39;451;719;1170
2020-04-29;VA;30-39;567;828;1395
2020-04-29;BU;40-49;661;914;1575
2020-04-29;SE;40-49;385;536;921
2020-04-29;CyL;40-49;3936;5780;9716
2020-04-29;BU;50-59;605;877;1482
2020-04-29;SA;50-59;701;1071;1772
2020-04-29;SA;60-69;584;650;1234
2020-04-29;SE;60-69;406;437;843
2020-04-29;SO;60-69;173;206;379
2020-04-29;BU;70-79;333;297;630
2020-04-29;PA;70-79;135;135;270
2020-04-29;AV;>80;334;514;848
2020-04-29;PA;>80;173;357;530
2020-04-29;SO;>80;319;579;898
2020-04-29;CyL;>80;3693;6384;10077
2020-04-29;AV;0-9;102;84;186
2020-04-29;PA;0-9;44;21;65
2020-04-29;SA;0-9;228;254;482
2020-04-29;SE;0-9;88;75;163
2020-04-29;SO;0-9;42;31;73
2020-04-29;BU;10-19;135;144;279
2020-04-29;PA;10-19;59;44;103
2020-04-29;SE;10-19;54;49;103
2020-04-29;BU;20-29;269;359;628
2020-04-29;SA;20-29;265;414;679
2020-04-29;SO;20-29;73;100;173
2020-04-29;CyL;20-29;1572;2223;3795
2020-04-29;AV;30-39;214;300;514
2020-04-29;SO;30-39;115;185;300
2020-04-29;AV;40-49;310;451;761
2020-04-29;LE;40-49;600;971;1571
2020-04-29;PA;40-49;259;332;591
2020-04-29;SO;40-49;194;302;496
2020-04-29;AV;50-59;291;444;735
2020-04-29;PA;50-59;236;346;582
2020-04-29;SE;50-59;465;703;1168
2020-04-29;VA;50-59;653;1019;1672
2020-04-29;CyL;50-59;3921;5946;9867
2020-04-29;AV;60-69;268;296;564
2020-04-29;BU;60-69;448;503;951
2020-04-29;LE;60-69;532;658;1190
2020-04-29;PA;60-69;200;205;405
2020-04-29;CyL;60-69;3264;3762;7026
2020-04-29;AV;70-79;213;222;435
2020-04-29;SE;70-79;298;240;538
2020-04-29;SO;70-79;132;108;240
2020-04-29;CyL;70-79;2522;2366;4888
2020-04-29;SE;>80;494;751;1245
2020-04-29;BU;0-9;172;135;307
2020-04-29;ZA;0-9;148;141;289
2020-04-29;AV;10-19;76;63;139
2020-04-29;VA;10-19;182;190;372
2020-04-29;ZA;10-19;40;44;84
2020-04-29;CyL;10-19;826;830;1656
2020-04-29;LE;20-29;223;327;550
2020-04-29;ZA;20-29;49;69;118
2020-04-29;BU;30-39;489;634;1123
2020-04-29;SE;30-39;231;313;544
2020-04-29;ZA;30-39;86;141;227
2020-04-29;CyL;30-39;2718;4015;6733
2020-04-29;SA;40-49;595;888;1483
2020-04-29;VA;40-49;793;1168;1961
2020-04-29;ZA;40-49;139;218;357
2020-04-29;LE;50-59;611;920;1531
2020-04-29;SO;50-59;221;346;567
2020-04-29;ZA;50-59;138;220;358
2020-04-29;VA;60-69;523;674;1197
2020-04-29;ZA;60-69;130;133;263
2020-04-29;LE;70-79;489;416;905
2020-04-29;SA;70-79;390;414;804
2020-04-29;VA;70-79;443;447;890
2020-04-29;ZA;70-79;89;87;176
2020-04-29;BU;>80;467;813;1280
2020-04-29;LE;>80;630;1132;1762
2020-04-29;SA;>80;613;949;1562
2020-04-29;VA;>80;536;1109;1645
2020-04-29;ZA;>80;127;180;307
2020-04-28;AV;0-9;99;81;180
2020-04-28;BU;0-9;173;135;308
2020-04-28;LE;0-9;194;182;376
2020-04-28;VA;0-9;305;265;570
2020-04-28;AV;10-19;76;61;137
2020-04-28;SE;10-19;51;48;99
2020-04-28;AV;20-29;122;159;281
2020-04-28;SA;20-29;262;403;665
2020-04-28;SE;20-29;140;208;348
2020-04-28;SO;20-29;69;100;169
2020-04-28;VA;20-29;315;457;772
2020-04-28;SO;30-39;111;183;294
2020-04-28;AV;40-49;303;444;747
2020-04-28;LE;40-49;597;960;1557
2020-04-28;PA;40-49;252;329;581
2020-04-28;SO;40-49;192;297;489
2020-04-28;AV;50-59;286;438;724
2020-04-28;SA;50-59;697;1061;1758
2020-04-28;VA;50-59;652;1012;1664
2020-04-28;AV;60-69;265;296;561
2020-04-28;BU;60-69;442;491;933
2020-04-28;PA;60-69;198;200;398
2020-04-28;SO;60-69;173;206;379
2020-04-28;AV;70-79;211;222;433
2020-04-28;SE;70-79;298;239;537
2020-04-28;CyL;70-79;2509;2354;4863
2020-04-28;AV;>80;333;511;844
2020-04-28;PA;>80;172;354;526
2020-04-28;SO;>80;319;578;897
2020-04-28;ZA;>80;127;171;298
2020-04-28;PA;0-9;44;20;64
2020-04-28;SE;0-9;87;75;162
2020-04-28;SO;0-9;42;31;73
2020-04-28;ZA;0-9;144;136;280
2020-04-28;CyL;0-9;1311;1175;2486
2020-04-28;BU;10-19;133;139;272
2020-04-28;LE;10-19;108;119;227
2020-04-28;PA;10-19;59;43;102
2020-04-28;SA;10-19;141;142;283
2020-04-28;ZA;10-19;39;44;83
2020-04-28;CyL;10-19;810;810;1620
2020-04-28;LE;20-29;215;327;542
2020-04-28;PA;20-29;108;124;232
2020-04-28;ZA;20-29;47;66;113
2020-04-28;CyL;20-29;1542;2199;3741
2020-04-28;AV;30-39;210;298;508
2020-04-28;LE;30-39;383;656;1039
2020-04-28;PA;30-39;171;232;403
2020-04-28;SA;30-39;445;711;1156
2020-04-28;SE;30-39;228;309;537
2020-04-28;VA;30-39;554;821;1375
2020-04-28;BU;40-49;659;907;1566
2020-04-28;SA;40-49;597;881;1478
2020-04-28;VA;40-49;790;1147;1937
2020-04-28;CyL;40-49;3910;5704;9614
2020-04-28;PA;50-59;232;344;576
2020-04-28;SO;50-59;218;339;557
2020-04-28;ZA;50-59;135;215;350
2020-04-28;CyL;50-59;3887;5873;9760
2020-04-28;LE;60-69;526;650;1176
2020-04-28;SA;60-69;575;644;1219
2020-04-28;BU;70-79;332;294;626
2020-04-28;LE;70-79;485;417;902
2020-04-28;PA;70-79;135;134;269
2020-04-28;VA;70-79;442;445;887
2020-04-28;BU;>80;465;805;1270
2020-04-28;LE;>80;625;1114;1739
2020-04-28;SA;>80;609;936;1545
2020-04-28;SE;>80;489;745;1234
2020-04-28;VA;>80;535;1108;1643
2020-04-28;CyL;>80;3674;6322;9996
2020-04-28;SA;0-9;223;250;473
2020-04-28;SO;10-19;28;29;57
2020-04-28;VA;10-19;175;185;360
2020-04-28;BU;20-29;264;355;619
2020-04-28;BU;30-39;483;622;1105
2020-04-28;ZA;30-39;84;137;221
2020-04-28;CyL;30-39;2669;3969;6638
2020-04-28;SE;40-49;383;525;908
2020-04-28;ZA;40-49;137;214;351
2020-04-28;BU;50-59;597;864;1461
2020-04-28;LE;50-59;606;911;1517
2020-04-28;SE;50-59;464;689;1153
2020-04-28;SE;60-69;401;426;827
2020-04-28;VA;60-69;516;670;1186
2020-04-28;ZA;60-69;127;127;254
2020-04-28;CyL;60-69;3223;3710;6933
2020-04-28;SA;70-79;389;413;802
2020-04-28;SO;70-79;132;107;239
2020-04-28;ZA;70-79;85;83;168
2020-04-27;LE;0-9;194;177;371
2020-04-27;SA;0-9;220;246;466
2020-04-27;SO;0-9;42;31;73
2020-04-27;VA;0-9;300;263;563
2020-04-27;ZA;0-9;141;133;274
2020-04-27;AV;10-19;74;60;134
2020-04-27;PA;10-19;57;42;99
2020-04-27;LE;20-29;210;320;530
2020-04-27;PA;20-29;105;121;226
2020-04-27;SE;20-29;140;203;343
2020-04-27;SO;20-29;67;99;166
2020-04-27;AV;30-39;206;298;504
2020-04-27;PA;30-39;167;227;394
2020-04-27;SE;30-39;222;302;524
2020-04-27;AV;40-49;302;441;743
2020-04-27;LE;40-49;590;952;1542
2020-04-27;PA;40-49;249;323;572
2020-04-27;ZA;40-49;133;207;340
2020-04-27;CyL;40-49;3869;5637;9506
2020-04-27;AV;50-59;286;433;719
2020-04-27;BU;50-59;593;851;1444
2020-04-27;BU;60-69;436;487;923
2020-04-27;PA;60-69;195;198;393
2020-04-27;SO;60-69;173;201;374
2020-04-27;AV;70-79;210;221;431
2020-04-27;LE;70-79;481;416;897
2020-04-27;PA;70-79;134;135;269
2020-04-27;AV;>80;333;507;840
2020-04-27;PA;>80;168;350;518
2020-04-27;SE;>80;489;736;1225
2020-04-27;AV;0-9;99;81;180
2020-04-27;BU;0-9;173;132;305
2020-04-27;SE;0-9;85;75;160
2020-04-27;BU;10-19;129;139;268
2020-04-27;SA;10-19;135;140;275
2020-04-27;AV;20-29;120;158;278
2020-04-27;BU;20-29;259;349;608
2020-04-27;SA;20-29;259;399;658
2020-04-27;ZA;20-29;44;64;108
2020-04-27;CyL;20-29;1517;2164;3681
2020-04-27;BU;30-39;471;613;1084
2020-04-27;LE;30-39;374;651;1025
2020-04-27;SA;30-39;440;703;1143
2020-04-27;VA;30-39;551;813;1364
2020-04-27;ZA;30-39;81;132;213
2020-04-27;CyL;30-39;2623;3921;6544
2020-04-27;SA;40-49;593;872;1465
2020-04-27;SE;40-49;378;510;888
2020-04-27;SO;40-49;192;290;482
2020-04-27;VA;40-49;779;1146;1925
2020-04-27;PA;50-59;231;340;571
2020-04-27;SE;50-59;460;675;1135
2020-04-27;CyL;50-59;3865;5802;9667
2020-04-27;SE;60-69;397;417;814
2020-04-27;VA;60-69;512;666;1178
2020-04-27;SO;70-79;131;107;238
2020-04-27;ZA;70-79;85;84;169
2020-04-27;CyL;70-79;2494;2346;4840
2020-04-27;BU;>80;461;797;1258
2020-04-27;LE;>80;617;1112;1729
2020-04-27;SA;>80;598;922;1520
2020-04-27;SO;>80;318;577;895
2020-04-27;VA;>80;533;1100;1633
2020-04-27;CyL;>80;3641;6267;9908
2020-04-27;PA;0-9;43;20;63
2020-04-27;CyL;0-9;1297;1158;2455
2020-04-27;LE;10-19;107;119;226
2020-04-27;SE;10-19;52;48;100
2020-04-27;SO;10-19;28;29;57
2020-04-27;VA;10-19;172;180;352
2020-04-27;ZA;10-19;39;41;80
2020-04-27;CyL;10-19;793;798;1591
2020-04-27;VA;20-29;313;451;764
2020-04-27;SO;30-39;111;182;293
2020-04-27;BU;40-49;653;896;1549
2020-04-27;LE;50-59;603;906;1509
2020-04-27;SA;50-59;697;1054;1751
2020-04-27;SO;50-59;217;334;551
2020-04-27;VA;50-59;647;999;1646
2020-04-27;ZA;50-59;131;210;341
2020-04-27;AV;60-69;264;296;560
2020-04-27;LE;60-69;522;648;1170
2020-04-27;SA;60-69;569;639;1208
2020-04-27;ZA;60-69;127;124;251
2020-04-27;CyL;60-69;3195;3676;6871
2020-04-27;BU;70-79;328;290;618
2020-04-27;SA;70-79;387;410;797
2020-04-27;SE;70-79;298;238;536
2020-04-27;VA;70-79;440;445;885
2020-04-27;ZA;>80;124;166;290
2020-04-26;AV;0-9;97;81;178
2020-04-26;BU;0-9;170;132;302
2020-04-26;CyL;0-9;1274;1135;2409
2020-04-26;AV;10-19;72;59;131
2020-04-26;BU;10-19;128;138;266
2020-04-26;SE;10-19;50;48;98
2020-04-26;PA;20-29;102;121;223
2020-04-26;SA;20-29;253;392;645
2020-04-26;SO;20-29;64;99;163
2020-04-26;VA;20-29;309;443;752
2020-04-26;ZA;20-29;44;64;108
2020-04-26;CyL;20-29;1485;2132;3617
2020-04-26;AV;30-39;204;297;501
2020-04-26;LE;30-39;368;643;1011
2020-04-26;PA;30-39;165;226;391
2020-04-26;SA;30-39;432;697;1129
2020-04-26;VA;30-39;542;796;1338
2020-04-26;ZA;30-39;79;133;212
2020-04-26;BU;40-49;643;896;1539
2020-04-26;ZA;40-49;130;202;332
2020-04-26;LE;50-59;596;893;1489
2020-04-26;PA;50-59;221;334;555
2020-04-26;SE;50-59;458;669;1127
2020-04-26;CyL;50-59;3803;5708;9511
2020-04-26;BU;60-69;431;478;909
2020-04-26;PA;60-69;191;198;389
2020-04-26;SA;60-69;566;637;1203
2020-04-26;VA;60-69;505;651;1156
2020-04-26;AV;70-79;209;221;430
2020-04-26;BU;70-79;323;285;608
2020-04-26;SA;70-79;385;403;788
2020-04-26;SE;70-79;297;235;532
2020-04-26;VA;70-79;436;439;875
2020-04-26;SA;>80;585;908;1493
2020-04-26;VA;>80;534;1094;1628
2020-04-26;ZA;>80;122;162;284
2020-04-26;LE;0-9;190;177;367
2020-04-26;SA;0-9;215;239;454
2020-04-26;SO;0-9;41;29;70
2020-04-26;VA;0-9;297;258;555
2020-04-26;ZA;0-9;137;129;266
2020-04-26;SA;10-19;133;135;268
2020-04-26;SO;10-19;27;28;55
2020-04-26;ZA;10-19;36;40;76
2020-04-26;LE;20-29;206;314;520
2020-04-26;SE;20-29;137;197;334
2020-04-26;BU;30-39;464;613;1077
2020-04-26;SO;30-39;111;178;289
2020-04-26;CyL;30-39;2584;3882;6466
2020-04-26;SA;40-49;581;861;1442
2020-04-26;VA;40-49;769;1132;1901
2020-04-26;CyL;40-49;3814;5586;9400
2020-04-26;AV;50-59;280;428;708
2020-04-26;SO;50-59;210;324;534
2020-04-26;VA;50-59;640;979;1619
2020-04-26;ZA;50-59;127;202;329
2020-04-26;AV;60-69;263;296;559
2020-04-26;ZA;60-69;124;118;242
2020-04-26;CyL;60-69;3158;3630;6788
2020-04-26;PA;70-79;132;134;266
2020-04-26;AV;>80;331;504;835
2020-04-26;BU;>80;453;779;1232
2020-04-26;LE;>80;612;1099;1711
2020-04-26;PA;>80;169;344;513
2020-04-26;SE;>80;471;709;1180
2020-04-26;CyL;>80;3594;6174;9768
2020-04-26;PA;0-9;43;20;63
2020-04-26;SE;0-9;84;70;154
2020-04-26;LE;10-19;107;118;225
2020-04-26;PA;10-19;57;41;98
2020-04-26;VA;10-19;171;179;350
2020-04-26;CyL;10-19;781;786;1567
2020-04-26;AV;20-29;114;156;270
2020-04-26;BU;20-29;256;346;602
2020-04-26;SE;30-39;219;299;518
2020-04-26;AV;40-49;296;435;731
2020-04-26;LE;40-49;581;942;1523
2020-04-26;PA;40-49;245;325;570
2020-04-26;SE;40-49;378;505;883
2020-04-26;SO;40-49;191;288;479
2020-04-26;BU;50-59;585;837;1422
2020-04-26;SA;50-59;686;1042;1728
2020-04-26;LE;60-69;517;639;1156
2020-04-26;SE;60-69;392;415;807
2020-04-26;SO;60-69;169;198;367
2020-04-26;LE;70-79;475;411;886
2020-04-26;SO;70-79;131;107;238
2020-04-26;ZA;70-79;80;81;161
2020-04-26;CyL;70-79;2468;2316;4784
2020-04-26;SO;>80;317;575;892
2020-04-25;SA;10-19;133;135;268
2020-04-25;ZA;10-19;36;40;76
2020-04-25;CyL;10-19;775;781;1556
2020-04-25;AV;20-29;113;153;266
2020-04-25;PA;20-29;101;120;221
2020-04-25;SA;20-29;252;390;642
2020-04-25;SE;20-29;136;194;330
2020-04-25;VA;20-29;307;438;745
2020-04-25;LE;30-39;369;644;1013
2020-04-25;SA;30-39;431;699;1130
2020-04-25;SE;30-39;218;297;515
2020-04-25;VA;30-39;536;796;1332
2020-04-25;PA;40-49;242;320;562
2020-04-25;SA;40-49;578;857;1435
2020-04-25;SE;40-49;376;497;873
2020-04-25;LE;50-59;595;891;1486
2020-04-25;PA;50-59;219;332;551
2020-04-25;CyL;50-59;3797;5683;9480
2020-04-25;LE;60-69;517;638;1155
2020-04-25;SA;60-69;566;636;1202
2020-04-25;SE;60-69;392;414;806
2020-04-25;SO;60-69;169;196;365
2020-04-25;CyL;60-69;3152;3615;6767
2020-04-25;BU;70-79;321;285;606
2020-04-25;ZA;70-79;80;81;161
2020-04-25;ZA;>80;120;163;283
2020-04-25;SA;0-9;215;239;454
2020-04-25;SO;0-9;41;29;70
2020-04-25;CyL;0-9;1273;1135;2408
2020-04-25;LE;10-19;107;117;224
2020-04-25;PA;10-19;56;41;97
2020-04-25;SE;10-19;49;45;94
2020-04-25;VA;10-19;168;179;347
2020-04-25;LE;20-29;206;314;520
2020-04-25;PA;30-39;164;225;389
2020-04-25;LE;40-49;579;936;1515
2020-04-25;SO;40-49;190;285;475
2020-04-25;VA;40-49;764;1127;1891
2020-04-25;CyL;40-49;3794;5548;9342
2020-04-25;SE;50-59;458;668;1126
2020-04-25;SO;50-59;211;321;532
2020-04-25;VA;50-59;639;971;1610
2020-04-25;BU;60-69;430;476;906
2020-04-25;PA;60-69;188;195;383
2020-04-25;ZA;60-69;124;118;242
2020-04-25;AV;70-79;208;221;429
2020-04-25;PA;70-79;132;131;263
2020-04-25;CyL;70-79;2457;2308;4765
2020-04-25;SA;>80;583;905;1488
2020-04-25;SE;>80;469;704;1173
2020-04-25;SO;>80;317;573;890
2020-04-25;AV;0-9;97;81;178
2020-04-25;BU;0-9;170;132;302
2020-04-25;LE;0-9;189;177;366
2020-04-25;PA;0-9;43;20;63
2020-04-25;SE;0-9;84;70;154
2020-04-25;VA;0-9;297;258;555
2020-04-25;ZA;0-9;137;129;266
2020-04-25;AV;10-19;72;59;131
2020-04-25;BU;10-19;127;137;264
2020-04-25;SO;10-19;27;28;55
2020-04-25;BU;20-29;257;344;601
2020-04-25;SO;20-29;62;97;159
2020-04-25;ZA;20-29;43;63;106
2020-04-25;CyL;20-29;1477;2113;3590
2020-04-25;AV;30-39;203;298;501
2020-04-25;BU;30-39;461;611;1072
2020-04-25;SO;30-39;107;178;285
2020-04-25;ZA;30-39;79;134;213
2020-04-25;CyL;30-39;2568;3882;6450
2020-04-25;AV;40-49;294;432;726
2020-04-25;BU;40-49;641;892;1533
2020-04-25;ZA;40-49;130;202;332
2020-04-25;AV;50-59;279;425;704
2020-04-25;BU;50-59;582;834;1416
2020-04-25;SA;50-59;686;1040;1726
2020-04-25;ZA;50-59;128;201;329
2020-04-25;AV;60-69;263;294;557
2020-04-25;VA;60-69;503;648;1151
2020-04-25;LE;70-79;473;410;883
2020-04-25;SA;70-79;384;402;786
2020-04-25;SE;70-79;297;235;532
2020-04-25;SO;70-79;130;107;237
2020-04-25;VA;70-79;432;436;868
2020-04-25;AV;>80;328;501;829
2020-04-25;BU;>80;452;764;1216
2020-04-25;LE;>80;609;1094;1703
2020-04-25;PA;>80;164;332;496
2020-04-25;VA;>80;526;1076;1602
2020-04-25;CyL;>80;3568;6112;9680
2020-04-24;AV;0-9;97;81;178
2020-04-24;BU;0-9;170;132;302
2020-04-24;ZA;0-9;137;129;266
2020-04-24;AV;10-19;72;59;131
2020-04-24;BU;20-29;257;346;603
2020-04-24;LE;20-29;206;314;520
2020-04-24;PA;20-29;101;119;220
2020-04-24;SA;20-29;249;384;633
2020-04-24;VA;20-29;306;438;744
2020-04-24;ZA;20-29;44;63;107
2020-04-24;BU;30-39;461;606;1067
2020-04-24;VA;30-39;536;789;1325
2020-04-24;AV;40-49;292;431;723
2020-04-24;PA;40-49;240;318;558
2020-04-24;SE;50-59;458;666;1124
2020-04-24;VA;50-59;639;969;1608
2020-04-24;ZA;50-59;125;200;325
2020-04-24;AV;60-69;262;293;555
2020-04-24;PA;60-69;188;194;382
2020-04-24;SA;60-69;559;633;1192
2020-04-24;SE;60-69;391;409;800
2020-04-24;SO;60-69;167;196;363
2020-04-24;BU;70-79;317;284;601
2020-04-24;PA;70-79;132;131;263
2020-04-24;BU;>80;449;763;1212
2020-04-24;LE;>80;607;1087;1694
2020-04-24;CyL;>80;3536;6051;9587
2020-04-24;PA;0-9;43;20;63
2020-04-24;VA;0-9;295;258;553
2020-04-24;CyL;0-9;1268;1133;2401
2020-04-24;BU;10-19;127;136;263
2020-04-24;SE;10-19;49;45;94
2020-04-24;SO;10-19;27;28;55
2020-04-24;ZA;10-19;36;40;76
2020-04-24;SE;20-29;135;191;326
2020-04-24;SO;20-29;61;96;157
2020-04-24;CyL;20-29;1471;2103;3574
2020-04-24;LE;30-39;369;641;1010
2020-04-24;SA;30-39;429;696;1125
2020-04-24;SE;30-39;218;293;511
2020-04-24;SO;30-39;109;176;285
2020-04-24;ZA;30-39;78;133;211
2020-04-24;SE;40-49;375;493;868
2020-04-24;SO;40-49;190;279;469
2020-04-24;VA;40-49;761;1126;1887
2020-04-24;CyL;40-49;3780;5522;9302
2020-04-24;AV;50-59;281;424;705
2020-04-24;BU;50-59;581;828;1409
2020-04-24;SO;50-59;211;318;529
2020-04-24;CyL;50-59;3792;5656;9448
2020-04-24;VA;60-69;502;647;1149
2020-04-24;AV;70-79;207;219;426
2020-04-24;LE;70-79;470;407;877
2020-04-24;SE;70-79;295;232;527
2020-04-24;VA;70-79;432;435;867
2020-04-24;CyL;70-79;2446;2292;4738
2020-04-24;AV;>80;323;489;812
2020-04-24;SA;>80;575;896;1471
2020-04-24;SE;>80;467;700;1167
2020-04-24;ZA;>80;118;159;277
2020-04-24;LE;0-9;188;176;364
2020-04-24;SA;0-9;213;238;451
2020-04-24;SE;0-9;84;70;154
2020-04-24;SO;0-9;41;29;70
2020-04-24;LE;10-19;107;117;224
2020-04-24;PA;10-19;55;41;96
2020-04-24;SA;10-19;133;135;268
2020-04-24;VA;10-19;168;178;346
2020-04-24;CyL;10-19;774;779;1553
2020-04-24;AV;20-29;112;152;264
2020-04-24;AV;30-39;200;294;494
2020-04-24;PA;30-39;164;224;388
2020-04-24;CyL;30-39;2564;3852;6416
2020-04-24;BU;40-49;642;887;1529
2020-04-24;LE;40-49;576;935;1511
2020-04-24;SA;40-49;576;852;1428
2020-04-24;ZA;40-49;128;201;329
2020-04-24;LE;50-59;594;888;1482
2020-04-24;PA;50-59;216;329;545
2020-04-24;SA;50-59;687;1034;1721
2020-04-24;BU;60-69;427;476;903
2020-04-24;LE;60-69;512;638;1150
2020-04-24;ZA;60-69;121;117;238
2020-04-24;CyL;60-69;3129;3603;6732
2020-04-24;SA;70-79;384;399;783
2020-04-24;SO;70-79;129;105;234
2020-04-24;ZA;70-79;80;80;160
2020-04-24;PA;>80;163;331;494
2020-04-24;SO;>80;309;552;861
2020-04-24;VA;>80;525;1074;1599
2020-04-23;AV;0-9;97;80;177
2020-04-23;PA;0-9;42;21;63
2020-04-23;ZA;0-9;136;125;261
2020-04-23;BU;10-19;128;134;262
2020-04-23;PA;20-29;102;119;221
2020-04-23;SO;20-29;61;94;155
2020-04-23;CyL;20-29;1447;2068;3515
2020-04-23;AV;30-39;198;291;489
2020-04-23;PA;30-39;164;220;384
2020-04-23;SA;30-39;423;690;1113
2020-04-23;SO;30-39;106;172;278
2020-04-23;CyL;30-39;2529;3799;6328
2020-04-23;LE;50-59;586;877;1463
2020-04-23;PA;50-59;215;320;535
2020-04-23;VA;60-69;497;629;1126
2020-04-23;ZA;60-69;118;113;231
2020-04-23;CyL;60-69;3104;3555;6659
2020-04-23;AV;70-79;206;216;422
2020-04-23;BU;70-79;320;281;601
2020-04-23;LE;70-79;466;402;868
2020-04-23;ZA;70-79;77;76;153
2020-04-23;CyL;70-79;2428;2270;4698
2020-04-23;ZA;>80;115;157;272
2020-04-23;CyL;>80;3495;5975;9470
2020-04-23;BU;0-9;169;129;298
2020-04-23;LE;0-9;186;173;359
2020-04-23;SA;0-9;211;234;445
2020-04-23;SE;0-9;84;69;153
2020-04-23;SO;0-9;40;29;69
2020-04-23;CyL;0-9;1250;1106;2356
2020-04-23;PA;10-19;51;41;92
2020-04-23;SE;10-19;49;44;93
2020-04-23;SO;10-19;27;28;55
2020-04-23;VA;10-19;166;174;340
2020-04-23;CyL;10-19;767;764;1531
2020-04-23;AV;20-29;111;149;260
2020-04-23;LE;20-29;203;308;511
2020-04-23;SA;20-29;244;380;624
2020-04-23;VA;20-29;301;430;731
2020-04-23;LE;30-39;363;630;993
2020-04-23;SE;30-39;216;286;502
2020-04-23;VA;30-39;531;781;1312
2020-04-23;AV;40-49;289;423;712
2020-04-23;PA;40-49;239;313;552
2020-04-23;SA;40-49;564;857;1421
2020-04-23;SE;40-49;371;487;858
2020-04-23;SO;40-49;188;273;461
2020-04-23;CyL;40-49;3726;5462;9188
2020-04-23;AV;50-59;276;422;698
2020-04-23;BU;50-59;575;818;1393
2020-04-23;SO;50-59;206;313;519
2020-04-23;VA;50-59;633;953;1586
2020-04-23;CyL;50-59;3750;5579;9329
2020-04-23;BU;60-69;422;471;893
2020-04-23;PA;60-69;187;194;381
2020-04-23;SE;60-69;386;407;793
2020-04-23;SO;60-69;168;186;354
2020-04-23;PA;70-79;131;129;260
2020-04-23;SA;70-79;378;395;773
2020-04-23;SE;70-79;292;231;523
2020-04-23;AV;>80;321;485;806
2020-04-23;BU;>80;442;760;1202
2020-04-23;LE;>80;590;1060;1650
2020-04-23;SA;>80;569;876;1445
2020-04-23;VA;>80;523;1067;1590
2020-04-23;VA;0-9;285;246;531
2020-04-23;AV;10-19;72;58;130
2020-04-23;LE;10-19;105;115;220
2020-04-23;SA;10-19;133;129;262
2020-04-23;ZA;10-19;36;41;77
2020-04-23;BU;20-29;252;343;595
2020-04-23;SE;20-29;131;185;316
2020-04-23;ZA;20-29;42;60;102
2020-04-23;BU;30-39;451;600;1051
2020-04-23;ZA;30-39;77;129;206
2020-04-23;BU;40-49;634;876;1510
2020-04-23;LE;40-49;571;925;1496
2020-04-23;VA;40-49;749;1111;1860
2020-04-23;ZA;40-49;121;197;318
2020-04-23;SA;50-59;678;1030;1708
2020-04-23;SE;50-59;455;654;1109
2020-04-23;ZA;50-59;126;192;318
2020-04-23;AV;60-69;259;291;550
2020-04-23;LE;60-69;510;634;1144
2020-04-23;SA;60-69;557;630;1187
2020-04-23;SO;70-79;128;105;233
2020-04-23;VA;70-79;430;435;865
2020-04-23;PA;>80;161;322;483
2020-04-23;SE;>80;468;695;1163
2020-04-23;SO;>80;306;553;859
2020-04-22;LE;0-9;186;173;359
2020-04-22;SA;0-9;210;233;443
2020-04-22;SO;0-9;40;29;69
2020-04-22;AV;10-19;72;58;130
2020-04-22;SE;10-19;49;44;93
2020-04-22;VA;10-19;165;172;337
2020-04-22;LE;20-29;202;306;508
2020-04-22;SE;20-29;129;182;311
2020-04-22;VA;20-29;299;429;728
2020-04-22;AV;30-39;196;287;483
2020-04-22;SE;30-39;216;280;496
2020-04-22;VA;30-39;524;776;1300
2020-04-22;CyL;30-39;2511;3766;6277
2020-04-22;AV;40-49;287;421;708
2020-04-22;PA;40-49;239;311;550
2020-04-22;AV;50-59;276;421;697
2020-04-22;LE;50-59;585;868;1453
2020-04-22;PA;50-59;215;318;533
2020-04-22;ZA;50-59;124;191;315
2020-04-22;CyL;50-59;3737;5551;9288
2020-04-22;CyL;60-69;3080;3536;6616
2020-04-22;BU;70-79;318;279;597
2020-04-22;PA;70-79;128;128;256
2020-04-22;SA;70-79;376;392;768
2020-04-22;SA;>80;565;872;1437
2020-04-22;ZA;>80;114;158;272
2020-04-22;CyL;>80;3441;5918;9359
2020-04-22;PA;0-9;42;20;62
2020-04-22;ZA;0-9;136;125;261
2020-04-22;BU;10-19;128;134;262
2020-04-22;LE;10-19;104;114;218
2020-04-22;PA;10-19;51;41;92
2020-04-22;SO;10-19;27;28;55
2020-04-22;ZA;10-19;36;41;77
2020-04-22;AV;20-29;111;150;261
2020-04-22;BU;20-29;251;342;593
2020-04-22;ZA;20-29;42;58;100
2020-04-22;BU;30-39;446;597;1043
2020-04-22;LE;30-39;362;626;988
2020-04-22;PA;30-39;163;218;381
2020-04-22;SA;40-49;565;854;1419
2020-04-22;SO;40-49;181;258;439
2020-04-22;VA;40-49;749;1113;1862
2020-04-22;CyL;40-49;3713;5428;9141
2020-04-22;SA;50-59;677;1024;1701
2020-04-22;SO;50-59;201;307;508
2020-04-22;BU;60-69;418;469;887
2020-04-22;SE;60-69;386;406;792
2020-04-22;SO;60-69;165;184;349
2020-04-22;ZA;60-69;116;113;229
2020-04-22;LE;70-79;458;396;854
2020-04-22;ZA;70-79;77;76;153
2020-04-22;BU;>80;430;746;1176
2020-04-22;SO;>80;306;553;859
2020-04-22;VA;>80;522;1064;1586
2020-04-22;AV;0-9;98;80;178
2020-04-22;BU;0-9;169;129;298
2020-04-22;SE;0-9;84;69;153
2020-04-22;VA;0-9;285;246;531
2020-04-22;CyL;0-9;1250;1104;2354
2020-04-22;SA;10-19;132;128;260
2020-04-22;CyL;10-19;764;760;1524
2020-04-22;PA;20-29;102;117;219
2020-04-22;SA;20-29;241;376;617
2020-04-22;SO;20-29;59;93;152
2020-04-22;CyL;20-29;1436;2053;3489
2020-04-22;SA;30-39;425;687;1112
2020-04-22;SO;30-39;103;168;271
2020-04-22;ZA;30-39;76;127;203
2020-04-22;BU;40-49;634;871;1505
2020-04-22;LE;40-49;572;923;1495
2020-04-22;SE;40-49;366;482;848
2020-04-22;ZA;40-49;120;195;315
2020-04-22;BU;50-59;574;818;1392
2020-04-22;SE;50-59;453;652;1105
2020-04-22;VA;50-59;632;952;1584
2020-04-22;AV;60-69;258;287;545
2020-04-22;LE;60-69;509;630;1139
2020-04-22;PA;60-69;185;194;379
2020-04-22;SA;60-69;549;626;1175
2020-04-22;VA;60-69;494;627;1121
2020-04-22;AV;70-79;206;216;422
2020-04-22;SE;70-79;291;231;522
2020-04-22;SO;70-79;126;104;230
2020-04-22;VA;70-79;430;433;863
2020-04-22;CyL;70-79;2410;2255;4665
2020-04-22;AV;>80;318;485;803
2020-04-22;LE;>80;561;1028;1589
2020-04-22;PA;>80;159;319;478
2020-04-22;SE;>80;466;693;1159
2020-04-21;AV;0-9;92;78;170
2020-04-21;LE;0-9;183;172;355
2020-04-21;SO;0-9;40;27;67
2020-04-21;VA;0-9;271;240;511
2020-04-21;CyL;0-9;1217;1088;2305
2020-04-21;SE;10-19;47;43;90
2020-04-21;BU;20-29;249;337;586
2020-04-21;BU;30-39;437;592;1029
2020-04-21;AV;40-49;286;415;701
2020-04-21;BU;50-59;570;811;1381
2020-04-21;PA;50-59;213;313;526
2020-04-21;SE;50-59;448;640;1088
2020-04-21;CyL;50-59;3693;5464;9157
2020-04-21;LE;60-69;505;625;1130
2020-04-21;PA;60-69;185;195;380
2020-04-21;CyL;60-69;3045;3499;6544
2020-04-21;AV;>80;317;481;798
2020-04-21;BU;>80;426;724;1150
2020-04-21;SE;>80;462;686;1148
2020-04-21;SO;>80;304;547;851
2020-04-21;CyL;>80;3401;5756;9157
2020-04-21;SA;0-9;208;231;439
2020-04-21;SE;0-9;83;69;152
2020-04-21;ZA;0-9;133;123;256
2020-04-21;AV;10-19;69;55;124
2020-04-21;LE;10-19;103;113;216
2020-04-21;PA;10-19;51;42;93
2020-04-21;SO;10-19;26;28;54
2020-04-21;ZA;10-19;34;41;75
2020-04-21;LE;20-29;198;304;502
2020-04-21;PA;20-29;100;113;213
2020-04-21;SE;20-29;125;179;304
2020-04-21;SO;20-29;59;91;150
2020-04-21;VA;20-29;296;419;715
2020-04-21;ZA;20-29;40;57;97
2020-04-21;AV;30-39;196;283;479
2020-04-21;SA;30-39;419;672;1091
2020-04-21;SE;30-39;209;277;486
2020-04-21;ZA;30-39;75;122;197
2020-04-21;CyL;30-39;2482;3697;6179
2020-04-21;SA;40-49;559;846;1405
2020-04-21;SO;40-49;179;255;434
2020-04-21;ZA;40-49;119;189;308
2020-04-21;CyL;40-49;3671;5347;9018
2020-04-21;LE;50-59;581;853;1434
2020-04-21;SO;50-59;193;303;496
2020-04-21;VA;50-59;625;929;1554
2020-04-21;SA;60-69;547;620;1167
2020-04-21;SO;60-69;162;183;345
2020-04-21;VA;60-69;486;615;1101
2020-04-21;ZA;60-69;115;110;225
2020-04-21;SO;70-79;125;101;226
2020-04-21;ZA;70-79;75;73;148
2020-04-21;LE;>80;549;955;1504
2020-04-21;PA;>80;158;307;465
2020-04-21;BU;0-9;167;128;295
2020-04-21;PA;0-9;40;20;60
2020-04-21;BU;10-19;125;130;255
2020-04-21;SA;10-19;130;127;257
2020-04-21;VA;10-19;153;163;316
2020-04-21;CyL;10-19;738;742;1480
2020-04-21;AV;20-29;108;148;256
2020-04-21;SA;20-29;239;369;608
2020-04-21;CyL;20-29;1414;2017;3431
2020-04-21;LE;30-39;361;614;975
2020-04-21;PA;30-39;164;210;374
2020-04-21;SO;30-39;103;165;268
2020-04-21;VA;30-39;518;762;1280
2020-04-21;BU;40-49;628;860;1488
2020-04-21;LE;40-49;561;905;1466
2020-04-21;PA;40-49;233;308;541
2020-04-21;SE;40-49;367;478;845
2020-04-21;VA;40-49;739;1091;1830
2020-04-21;AV;50-59;271;416;687
2020-04-21;SA;50-59;672;1013;1685
2020-04-21;ZA;50-59;120;186;306
2020-04-21;AV;60-69;257;285;542
2020-04-21;BU;60-69;414;467;881
2020-04-21;SE;60-69;374;399;773
2020-04-21;AV;70-79;201;214;415
2020-04-21;BU;70-79;314;277;591
2020-04-21;LE;70-79;455;387;842
2020-04-21;PA;70-79;127;125;252
2020-04-21;SA;70-79;374;384;758
2020-04-21;SE;70-79;289;228;517
2020-04-21;VA;70-79;424;435;859
2020-04-21;CyL;70-79;2384;2224;4608
2020-04-21;SA;>80;558;848;1406
2020-04-21;VA;>80;515;1056;1571
2020-04-21;ZA;>80;112;152;264
2020-04-20;AV;0-9;92;77;169
2020-04-20;PA;0-9;40;20;60
2020-04-20;SE;0-9;83;69;152
2020-04-20;LE;10-19;104;112;216
2020-04-20;PA;10-19;51;42;93
2020-04-20;VA;10-19;146;158;304
2020-04-20;AV;20-29;108;144;252
2020-04-20;LE;20-29;197;299;496
2020-04-20;SE;20-29;124;175;299
2020-04-20;CyL;20-29;1397;1981;3378
2020-04-20;AV;30-39;194;280;474
2020-04-20;BU;30-39;429;583;1012
2020-04-20;AV;40-49;278;407;685
2020-04-20;LE;40-49;557;897;1454
2020-04-20;PA;40-49;232;303;535
2020-04-20;SO;40-49;174;251;425
2020-04-20;VA;40-49;726;1079;1805
2020-04-20;AV;50-59;267;417;684
2020-04-20;PA;50-59;213;308;521
2020-04-20;SA;50-59;665;1009;1674
2020-04-20;SE;50-59;445;621;1066
2020-04-20;SO;50-59;194;301;495
2020-04-20;ZA;50-59;117;179;296
2020-04-20;BU;60-69;411;463;874
2020-04-20;PA;60-69;179;195;374
2020-04-20;SA;60-69;541;610;1151
2020-04-20;VA;60-69;480;610;1090
2020-04-20;ZA;60-69;113;109;222
2020-04-20;LE;70-79;449;386;835
2020-04-20;PA;70-79;124;123;247
2020-04-20;SA;70-79;366;375;741
2020-04-20;VA;70-79;416;430;846
2020-04-20;PA;>80;151;302;453
2020-04-20;SE;>80;449;645;1094
2020-04-20;ZA;>80;111;149;260
2020-04-20;SA;0-9;207;227;434
2020-04-20;SO;0-9;40;27;67
2020-04-20;CyL;0-9;1201;1076;2277
2020-04-20;AV;10-19;68;54;122
2020-04-20;BU;10-19;123;130;253
2020-04-20;SO;10-19;25;27;52
2020-04-20;BU;20-29;242;334;576
2020-04-20;ZA;20-29;38;54;92
2020-04-20;LE;30-39;356;607;963
2020-04-20;SA;30-39;415;661;1076
2020-04-20;VA;30-39;507;747;1254
2020-04-20;CyL;30-39;2441;3637;6078
2020-04-20;BU;40-49;615;849;1464
2020-04-20;SA;40-49;548;837;1385
2020-04-20;ZA;40-49;116;179;295
2020-04-20;CyL;40-49;3606;5275;8881
2020-04-20;BU;50-59;558;798;1356
2020-04-20;VA;50-59;615;910;1525
2020-04-20;LE;60-69;503;617;1120
2020-04-20;SE;60-69;366;395;761
2020-04-20;SO;60-69;156;180;336
2020-04-20;AV;70-79;200;208;408
2020-04-20;BU;70-79;313;272;585
2020-04-20;CyL;70-79;2352;2183;4535
2020-04-20;AV;>80;315;476;791
2020-04-20;SA;>80;534;809;1343
2020-04-20;SO;>80;296;513;809
2020-04-20;BU;0-9;164;125;289
2020-04-20;LE;0-9;183;173;356
2020-04-20;VA;0-9;263;235;498
2020-04-20;ZA;0-9;129;123;252
2020-04-20;SA;10-19;130;124;254
2020-04-20;SE;10-19;47;43;90
2020-04-20;ZA;10-19;33;39;72
2020-04-20;CyL;10-19;727;729;1456
2020-04-20;PA;20-29;101;115;216
2020-04-20;SA;20-29;236;365;601
2020-04-20;SO;20-29;58;87;145
2020-04-20;VA;20-29;293;408;701
2020-04-20;PA;30-39;162;205;367
2020-04-20;SE;30-39;205;275;480
2020-04-20;SO;30-39;101;162;263
2020-04-20;ZA;30-39;72;117;189
2020-04-20;SE;40-49;360;473;833
2020-04-20;LE;50-59;572;840;1412
2020-04-20;CyL;50-59;3646;5383;9029
2020-04-20;AV;60-69;256;284;540
2020-04-20;CyL;60-69;3005;3463;6468
2020-04-20;SE;70-79;287;221;508
2020-04-20;SO;70-79;122;97;219
2020-04-20;ZA;70-79;75;71;146
2020-04-20;BU;>80;425;713;1138
2020-04-20;LE;>80;545;925;1470
2020-04-20;VA;>80;505;1046;1551
2020-04-20;CyL;>80;3331;5578;8909
2020-04-19;PA;0-9;40;20;60
2020-04-19;SO;0-9;40;26;66
2020-04-19;LE;10-19;99;108;207
2020-04-19;SA;10-19;126;124;250
2020-04-19;BU;20-29;238;328;566
2020-04-19;SE;20-29;124;172;296
2020-04-19;AV;30-39;188;268;456
2020-04-19;BU;30-39;422;573;995
2020-04-19;LE;30-39;344;588;932
2020-04-19;PA;30-39;160;201;361
2020-04-19;CyL;30-39;2395;3559;5954
2020-04-19;VA;40-49;702;1056;1758
2020-04-19;ZA;40-49;108;172;280
2020-04-19;AV;50-59;261;411;672
2020-04-19;LE;50-59;561;826;1387
2020-04-19;SO;50-59;191;293;484
2020-04-19;VA;50-59;607;889;1496
2020-04-19;BU;60-69;404;452;856
2020-04-19;LE;60-69;499;610;1109
2020-04-19;SE;60-69;362;393;755
2020-04-19;CyL;60-69;2960;3411;6371
2020-04-19;SA;70-79;359;371;730
2020-04-19;SO;70-79;121;93;214
2020-04-19;VA;70-79;414;426;840
2020-04-19;CyL;70-79;2321;2144;4465
2020-04-19;LE;>80;538;889;1427
2020-04-19;SA;>80;520;787;1307
2020-04-19;SO;>80;280;452;732
2020-04-19;CyL;>80;3251;5367;8618
2020-04-19;BU;0-9;162;123;285
2020-04-19;SA;0-9;202;226;428
2020-04-19;ZA;0-9;126;120;246
2020-04-19;CyL;0-9;1177;1059;2236
2020-04-19;AV;10-19;65;54;119
2020-04-19;BU;10-19;121;124;245
2020-04-19;PA;10-19;51;41;92
2020-04-19;SO;10-19;25;27;52
2020-04-19;ZA;10-19;31;37;68
2020-04-19;CyL;10-19;710;708;1418
2020-04-19;AV;20-29;108;139;247
2020-04-19;VA;20-29;284;403;687
2020-04-19;SA;30-39;410;649;1059
2020-04-19;SE;30-39;204;270;474
2020-04-19;AV;40-49;273;402;675
2020-04-19;BU;40-49;599;837;1436
2020-04-19;LE;40-49;545;881;1426
2020-04-19;PA;40-49;231;295;526
2020-04-19;SE;40-49;355;470;825
2020-04-19;CyL;40-49;3521;5177;8698
2020-04-19;PA;50-59;211;302;513
2020-04-19;ZA;50-59;114;172;286
2020-04-19;AV;60-69;250;282;532
2020-04-19;SO;60-69;157;177;334
2020-04-19;AV;70-79;194;205;399
2020-04-19;BU;70-79;309;264;573
2020-04-19;PA;70-79;123;117;240
2020-04-19;SE;70-79;286;218;504
2020-04-19;AV;>80;303;442;745
2020-04-19;AV;0-9;89;75;164
2020-04-19;LE;0-9;181;171;352
2020-04-19;SE;0-9;82;67;149
2020-04-19;VA;0-9;255;231;486
2020-04-19;SE;10-19;48;43;91
2020-04-19;VA;10-19;144;150;294
2020-04-19;LE;20-29;193;293;486
2020-04-19;PA;20-29;98;113;211
2020-04-19;SA;20-29;230;363;593
2020-04-19;SO;20-29;58;86;144
2020-04-19;ZA;20-29;35;52;87
2020-04-19;CyL;20-29;1368;1949;3317
2020-04-19;SO;30-39;95;159;254
2020-04-19;VA;30-39;501;735;1236
2020-04-19;ZA;30-39;71;116;187
2020-04-19;SA;40-49;537;816;1353
2020-04-19;SO;40-49;171;248;419
2020-04-19;BU;50-59;550;777;1327
2020-04-19;SA;50-59;650;998;1648
2020-04-19;SE;50-59;443;607;1050
2020-04-19;CyL;50-59;3588;5275;8863
2020-04-19;PA;60-69;174;196;370
2020-04-19;SA;60-69;535;600;1135
2020-04-19;VA;60-69;470;597;1067
2020-04-19;ZA;60-69;109;104;213
2020-04-19;LE;70-79;445;383;828
2020-04-19;ZA;70-79;70;67;137
2020-04-19;BU;>80;417;701;1118
2020-04-19;PA;>80;148;292;440
2020-04-19;SE;>80;440;621;1061
2020-04-19;VA;>80;497;1039;1536
2020-04-19;ZA;>80;108;144;252
2020-04-18;SA;0-9;201;226;427
2020-04-18;VA;0-9;255;228;483
2020-04-18;AV;10-19;65;54;119
2020-04-18;BU;10-19;120;123;243
2020-04-18;VA;10-19;144;150;294
2020-04-18;ZA;10-19;31;37;68
2020-04-18;LE;20-29;192;293;485
2020-04-18;SA;20-29;229;362;591
2020-04-18;SE;20-29;124;170;294
2020-04-18;SO;20-29;58;86;144
2020-04-18;AV;30-39;189;270;459
2020-04-18;LE;30-39;341;587;928
2020-04-18;ZA;30-39;71;115;186
2020-04-18;BU;40-49;600;832;1432
2020-04-18;PA;40-49;227;291;518
2020-04-18;SE;40-49;353;468;821
2020-04-18;SO;40-49;171;247;418
2020-04-18;AV;50-59;260;412;672
2020-04-18;CyL;50-59;3581;5252;8833
2020-04-18;LE;60-69;496;608;1104
2020-04-18;SE;60-69;362;391;753
2020-04-18;VA;60-69;467;592;1059
2020-04-18;ZA;60-69;109;104;213
2020-04-18;VA;70-79;412;425;837
2020-04-18;ZA;70-79;70;67;137
2020-04-18;AV;>80;300;441;741
2020-04-18;BU;>80;415;684;1099
2020-04-18;CyL;>80;3198;5238;8436
2020-04-18;BU;0-9;161;123;284
2020-04-18;LE;0-9;181;170;351
2020-04-18;CyL;0-9;1175;1056;2231
2020-04-18;PA;10-19;51;41;92
2020-04-18;SA;10-19;125;123;248
2020-04-18;SO;10-19;24;27;51
2020-04-18;BU;20-29;234;327;561
2020-04-18;ZA;20-29;35;52;87
2020-04-18;CyL;20-29;1361;1943;3304
2020-04-18;PA;30-39;159;199;358
2020-04-18;SO;30-39;93;157;250
2020-04-18;CyL;30-39;2386;3551;5937
2020-04-18;SA;40-49;536;808;1344
2020-04-18;SA;50-59;648;993;1641
2020-04-18;SE;50-59;440;599;1039
2020-04-18;SO;50-59;192;291;483
2020-04-18;ZA;50-59;115;172;287
2020-04-18;SA;60-69;531;595;1126
2020-04-18;SO;60-69;155;176;331
2020-04-18;BU;70-79;307;264;571
2020-04-18;PA;70-79;122;116;238
2020-04-18;SO;70-79;118;88;206
2020-04-18;CyL;70-79;2308;2130;4438
2020-04-18;LE;>80;527;872;1399
2020-04-18;ZA;>80;107;142;249
2020-04-18;AV;0-9;89;75;164
2020-04-18;PA;0-9;40;20;60
2020-04-18;SE;0-9;82;68;150
2020-04-18;SO;0-9;40;26;66
2020-04-18;ZA;0-9;126;120;246
2020-04-18;LE;10-19;99;107;206
2020-04-18;SE;10-19;48;42;90
2020-04-18;CyL;10-19;707;704;1411
2020-04-18;AV;20-29;109;139;248
2020-04-18;PA;20-29;98;112;210
2020-04-18;VA;20-29;282;402;684
2020-04-18;BU;30-39;423;573;996
2020-04-18;SA;30-39;410;650;1060
2020-04-18;SE;30-39;204;267;471
2020-04-18;VA;30-39;496;733;1229
2020-04-18;AV;40-49;271;400;671
2020-04-18;LE;40-49;545;878;1423
2020-04-18;VA;40-49;701;1056;1757
2020-04-18;ZA;40-49;108;172;280
2020-04-18;CyL;40-49;3512;5152;8664
2020-04-18;BU;50-59;548;769;1317
2020-04-18;LE;50-59;562;827;1389
2020-04-18;PA;50-59;212;303;515
2020-04-18;VA;50-59;604;886;1490
2020-04-18;AV;60-69;249;282;531
2020-04-18;BU;60-69;401;453;854
2020-04-18;PA;60-69;171;194;365
2020-04-18;CyL;60-69;2941;3395;6336
2020-04-18;AV;70-79;194;203;397
2020-04-18;LE;70-79;442;381;823
2020-04-18;SA;70-79;358;370;728
2020-04-18;SE;70-79;285;216;501
2020-04-18;PA;>80;144;287;431
2020-04-18;SA;>80;513;766;1279
2020-04-18;SE;>80;435;600;1035
2020-04-18;SO;>80;262;410;672
2020-04-18;VA;>80;495;1036;1531
2020-04-17;BU;0-9;161;123;284
2020-04-17;PA;0-9;38;19;57
2020-04-17;SA;0-9;201;224;425
2020-04-17;SE;0-9;82;67;149
2020-04-17;BU;10-19;119;122;241
2020-04-17;PA;10-19;50;41;91
2020-04-17;VA;10-19;143;150;293
2020-04-17;ZA;10-19;31;37;68
2020-04-17;AV;20-29;108;137;245
2020-04-17;LE;20-29;191;294;485
2020-04-17;CyL;20-29;1356;1933;3289
2020-04-17;AV;30-39;190;267;457
2020-04-17;LE;30-39;341;587;928
2020-04-17;PA;30-39;159;196;355
2020-04-17;SE;30-39;203;265;468
2020-04-17;SO;30-39;95;152;247
2020-04-17;CyL;30-39;2384;3528;5912
2020-04-17;BU;40-49;598;830;1428
2020-04-17;SO;40-49;171;244;415
2020-04-17;PA;50-59;209;304;513
2020-04-17;BU;60-69;399;450;849
2020-04-17;LE;60-69;496;607;1103
2020-04-17;SA;60-69;529;596;1125
2020-04-17;SE;60-69;358;390;748
2020-04-17;SO;60-69;153;175;328
2020-04-17;BU;70-79;304;263;567
2020-04-17;LE;70-79;436;379;815
2020-04-17;ZA;70-79;69;67;136
2020-04-17;PA;>80;145;282;427
2020-04-17;AV;10-19;64;54;118
2020-04-17;SA;10-19;126;122;248
2020-04-17;SE;10-19;48;42;90
2020-04-17;PA;20-29;98;112;210
2020-04-17;SE;20-29;123;168;291
2020-04-17;SO;20-29;57;86;143
2020-04-17;VA;20-29;281;399;680
2020-04-17;SA;30-39;410;646;1056
2020-04-17;ZA;30-39;71;115;186
2020-04-17;AV;40-49;269;397;666
2020-04-17;CyL;40-49;3507;5120;8627
2020-04-17;AV;50-59;257;409;666
2020-04-17;BU;50-59;551;765;1316
2020-04-17;VA;50-59;604;880;1484
2020-04-17;CyL;50-59;3566;5230;8796
2020-04-17;SO;70-79;117;86;203
2020-04-17;VA;70-79;412;425;837
2020-04-17;CyL;70-79;2288;2110;4398
2020-04-17;LE;>80;521;862;1383
2020-04-17;SA;>80;508;759;1267
2020-04-17;SE;>80;419;554;973
2020-04-17;CyL;>80;3156;5141;8297
2020-04-17;AV;0-9;90;74;164
2020-04-17;LE;0-9;181;170;351
2020-04-17;SO;0-9;39;26;65
2020-04-17;VA;0-9;255;226;481
2020-04-17;ZA;0-9;126;120;246
2020-04-17;CyL;0-9;1173;1049;2222
2020-04-17;LE;10-19;99;107;206
2020-04-17;SO;10-19;24;27;51
2020-04-17;CyL;10-19;704;702;1406
2020-04-17;BU;20-29;234;325;559
2020-04-17;SA;20-29;229;360;589
2020-04-17;ZA;20-29;35;52;87
2020-04-17;BU;30-39;422;567;989
2020-04-17;VA;30-39;493;733;1226
2020-04-17;LE;40-49;545;876;1421
2020-04-17;PA;40-49;224;290;514
2020-04-17;SA;40-49;533;802;1335
2020-04-17;SE;40-49;353;461;814
2020-04-17;VA;40-49;705;1049;1754
2020-04-17;ZA;40-49;109;171;280
2020-04-17;LE;50-59;561;828;1389
2020-04-17;SA;50-59;646;989;1635
2020-04-17;SE;50-59;434;592;1026
2020-04-17;SO;50-59;190;291;481
2020-04-17;ZA;50-59;114;172;286
2020-04-17;AV;60-69;247;281;528
2020-04-17;PA;60-69;171;191;362
2020-04-17;VA;60-69;464;590;1054
2020-04-17;ZA;60-69;108;103;211
2020-04-17;CyL;60-69;2925;3383;6308
2020-04-17;AV;70-79;192;201;393
2020-04-17;PA;70-79;119;111;230
2020-04-17;SA;70-79;357;365;722
2020-04-17;SE;70-79;282;213;495
2020-04-17;AV;>80;297;431;728
2020-04-17;BU;>80;409;675;1084
2020-04-17;SO;>80;258;403;661
2020-04-17;VA;>80;493;1032;1525
2020-04-17;ZA;>80;106;143;249
2020-04-16;SO;0-9;37;25;62
2020-04-16;CyL;0-9;1153;1030;2183
2020-04-16;PA;10-19;51;39;90
2020-04-16;SA;10-19;125;121;246
2020-04-16;SE;10-19;48;41;89
2020-04-16;ZA;10-19;31;37;68
2020-04-16;CyL;10-19;695;686;1381
2020-04-16;LE;30-39;341;576;917
2020-04-16;PA;30-39;153;192;345
2020-04-16;SA;30-39;395;635;1030
2020-04-16;SE;30-39;201;261;462
2020-04-16;VA;30-39;486;712;1198
2020-04-16;BU;40-49;585;805;1390
2020-04-16;SA;40-49;522;790;1312
2020-04-16;SO;40-49;167;240;407
2020-04-16;VA;40-49;694;1023;1717
2020-04-16;AV;50-59;252;395;647
2020-04-16;BU;50-59;540;757;1297
2020-04-16;LE;50-59;544;797;1341
2020-04-16;SA;50-59;637;966;1603
2020-04-16;VA;50-59;601;866;1467
2020-04-16;VA;60-69;459;590;1049
2020-04-16;SO;>80;248;380;628
2020-04-16;ZA;>80;105;136;241
2020-04-16;LE;0-9;181;166;347
2020-04-16;SE;0-9;81;65;146
2020-04-16;VA;0-9;246;222;468
2020-04-16;AV;10-19;62;52;114
2020-04-16;BU;10-19;117;120;237
2020-04-16;LE;10-19;100;107;207
2020-04-16;VA;10-19;137;143;280
2020-04-16;AV;20-29;106;133;239
2020-04-16;BU;20-29;229;317;546
2020-04-16;SA;20-29;225;355;580
2020-04-16;SO;20-29;57;85;142
2020-04-16;VA;20-29;278;389;667
2020-04-16;CyL;20-29;1333;1891;3224
2020-04-16;SO;30-39;94;147;241
2020-04-16;AV;40-49;269;389;658
2020-04-16;PA;40-49;219;284;503
2020-04-16;SE;50-59;427;581;1008
2020-04-16;ZA;50-59;108;165;273
2020-04-16;CyL;50-59;3505;5110;8615
2020-04-16;AV;60-69;243;275;518
2020-04-16;PA;60-69;170;191;361
2020-04-16;SA;60-69;525;579;1104
2020-04-16;ZA;60-69;99;97;196
2020-04-16;CyL;60-69;2882;3314;6196
2020-04-16;PA;70-79;119;111;230
2020-04-16;SA;70-79;351;356;707
2020-04-16;SE;70-79;280;210;490
2020-04-16;AV;>80;288;413;701
2020-04-16;BU;>80;394;632;1026
2020-04-16;SA;>80;498;721;1219
2020-04-16;AV;0-9;90;74;164
2020-04-16;BU;0-9;160;122;282
2020-04-16;PA;0-9;37;19;56
2020-04-16;SA;0-9;200;222;422
2020-04-16;ZA;0-9;121;115;236
2020-04-16;SO;10-19;24;26;50
2020-04-16;LE;20-29;188;287;475
2020-04-16;PA;20-29;96;109;205
2020-04-16;SE;20-29;120;165;285
2020-04-16;ZA;20-29;34;51;85
2020-04-16;AV;30-39;184;263;447
2020-04-16;BU;30-39;416;550;966
2020-04-16;ZA;30-39;68;111;179
2020-04-16;CyL;30-39;2338;3447;5785
2020-04-16;LE;40-49;535;851;1386
2020-04-16;SE;40-49;348;455;803
2020-04-16;ZA;40-49;104;155;259
2020-04-16;CyL;40-49;3443;4992;8435
2020-04-16;PA;50-59;208;297;505
2020-04-16;SO;50-59;188;286;474
2020-04-16;BU;60-69;394;443;837
2020-04-16;LE;60-69;486;582;1068
2020-04-16;SE;60-69;357;385;742
2020-04-16;SO;60-69;149;172;321
2020-04-16;AV;70-79;187;199;386
2020-04-16;BU;70-79;293;252;545
2020-04-16;LE;70-79;428;369;797
2020-04-16;SO;70-79;114;85;199
2020-04-16;VA;70-79;410;416;826
2020-04-16;ZA;70-79;68;61;129
2020-04-16;CyL;70-79;2250;2059;4309
2020-04-16;LE;>80;512;818;1330
2020-04-16;PA;>80;143;285;428
2020-04-16;SE;>80;413;546;959
2020-04-16;VA;>80;492;1025;1517
2020-04-16;CyL;>80;3093;4956;8049
2020-04-15;BU;0-9;157;122;279
2020-04-15;LE;0-9;180;164;344
2020-04-15;PA;0-9;37;18;55
2020-04-15;VA;0-9;236;210;446
2020-04-15;ZA;0-9;120;114;234
2020-04-15;CyL;0-9;1133;1006;2139
2020-04-15;AV;10-19;60;50;110
2020-04-15;BU;10-19;117;118;235
2020-04-15;PA;10-19;51;36;87
2020-04-15;SA;20-29;222;350;572
2020-04-15;SO;20-29;55;82;137
2020-04-15;CyL;20-29;1316;1858;3174
2020-04-15;AV;30-39;181;257;438
2020-04-15;SA;30-39;391;623;1014
2020-04-15;LE;40-49;523;833;1356
2020-04-15;SE;40-49;351;453;804
2020-04-15;ZA;40-49;100;152;252
2020-04-15;CyL;40-49;3392;4897;8289
2020-04-15;BU;50-59;538;734;1272
2020-04-15;LE;50-59;535;790;1325
2020-04-15;PA;50-59;206;289;495
2020-04-15;SA;50-59;632;952;1584
2020-04-15;AV;60-69;242;270;512
2020-04-15;PA;60-69;169;189;358
2020-04-15;VA;60-69;459;579;1038
2020-04-15;PA;70-79;114;104;218
2020-04-15;SE;70-79;279;209;488
2020-04-15;SO;70-79;113;85;198
2020-04-15;VA;70-79;406;414;820
2020-04-15;AV;>80;283;406;689
2020-04-15;BU;>80;390;614;1004
2020-04-15;SO;>80;247;379;626
2020-04-15;CyL;>80;3063;4876;7939
2020-04-15;SA;0-9;200;219;419
2020-04-15;SE;0-9;80;63;143
2020-04-15;SA;10-19;123;117;240
2020-04-15;SE;10-19;46;38;84
2020-04-15;SO;10-19;24;26;50
2020-04-15;VA;10-19;135;138;273
2020-04-15;LE;20-29;185;283;468
2020-04-15;PA;20-29;94;105;199
2020-04-15;SE;20-29;121;162;283
2020-04-15;ZA;20-29;34;50;84
2020-04-15;SO;30-39;91;144;235
2020-04-15;BU;40-49;577;793;1370
2020-04-15;SA;40-49;516;778;1294
2020-04-15;SO;40-49;164;238;402
2020-04-15;SE;50-59;425;577;1002
2020-04-15;ZA;50-59;106;164;270
2020-04-15;BU;60-69;387;433;820
2020-04-15;CyL;60-69;2844;3261;6105
2020-04-15;AV;70-79;184;196;380
2020-04-15;ZA;70-79;66;61;127
2020-04-15;CyL;70-79;2220;2034;4254
2020-04-15;LE;>80;512;807;1319
2020-04-15;SE;>80;410;542;952
2020-04-15;VA;>80;489;1018;1507
2020-04-15;ZA;>80;100;128;228
2020-04-15;AV;0-9;89;72;161
2020-04-15;SO;0-9;34;24;58
2020-04-15;LE;10-19;98;107;205
2020-04-15;ZA;10-19;31;35;66
2020-04-15;CyL;10-19;685;665;1350
2020-04-15;AV;20-29;103;131;234
2020-04-15;BU;20-29;224;314;538
2020-04-15;VA;20-29;278;381;659
2020-04-15;BU;30-39;411;546;957
2020-04-15;LE;30-39;336;569;905
2020-04-15;PA;30-39;150;191;341
2020-04-15;SE;30-39;198;257;455
2020-04-15;VA;30-39;476;699;1175
2020-04-15;ZA;30-39;67;109;176
2020-04-15;CyL;30-39;2301;3395;5696
2020-04-15;AV;40-49;267;377;644
2020-04-15;PA;40-49;215;280;495
2020-04-15;VA;40-49;679;993;1672
2020-04-15;AV;50-59;247;383;630
2020-04-15;SO;50-59;187;284;471
2020-04-15;VA;50-59;591;850;1441
2020-04-15;CyL;50-59;3467;5023;8490
2020-04-15;LE;60-69;482;572;1054
2020-04-15;SA;60-69;513;573;1086
2020-04-15;SE;60-69;351;381;732
2020-04-15;SO;60-69;146;170;316
2020-04-15;ZA;60-69;95;94;189
2020-04-15;BU;70-79;289;248;537
2020-04-15;LE;70-79;427;365;792
2020-04-15;SA;70-79;342;352;694
2020-04-15;PA;>80;139;275;414
2020-04-15;SA;>80;493;707;1200
2020-04-14;AV;0-9;88;68;156
2020-04-14;BU;0-9;154;120;274
2020-04-14;PA;10-19;48;36;84
2020-04-14;SA;10-19;118;116;234
2020-04-14;SE;10-19;42;38;80
2020-04-14;BU;20-29;212;303;515
2020-04-14;SA;20-29;213;344;557
2020-04-14;VA;20-29;253;360;613
2020-04-14;ZA;20-29;33;48;81
2020-04-14;BU;30-39;401;536;937
2020-04-14;PA;30-39;148;182;330
2020-04-14;SE;30-39;191;254;445
2020-04-14;VA;30-39;467;672;1139
2020-04-14;ZA;30-39;62;107;169
2020-04-14;LE;40-49;498;798;1296
2020-04-14;PA;40-49;214;278;492
2020-04-14;BU;50-59;516;703;1219
2020-04-14;LE;50-59;514;744;1258
2020-04-14;SO;50-59;176;269;445
2020-04-14;CyL;50-59;3337;4814;8151
2020-04-14;AV;60-69;232;257;489
2020-04-14;PA;60-69;165;184;349
2020-04-14;SA;60-69;491;551;1042
2020-04-14;SO;60-69;129;158;287
2020-04-14;CyL;60-69;2680;3093;5773
2020-04-14;AV;70-79;161;167;328
2020-04-14;SE;70-79;241;192;433
2020-04-14;ZA;70-79;56;56;112
2020-04-14;AV;>80;238;339;577
2020-04-14;BU;>80;322;497;819
2020-04-14;LE;>80;426;614;1040
2020-04-14;PA;>80;129;221;350
2020-04-14;SE;>80;313;434;747
2020-04-14;VA;>80;434;899;1333
2020-04-14;SE;0-9;77;63;140
2020-04-14;SO;0-9;34;24;58
2020-04-14;VA;0-9;228;199;427
2020-04-14;CyL;0-9;1099;984;2083
2020-04-14;LE;10-19;95;103;198
2020-04-14;ZA;10-19;30;34;64
2020-04-14;CyL;10-19;653;642;1295
2020-04-14;PA;20-29;91;101;192
2020-04-14;SO;20-29;54;76;130
2020-04-14;CyL;20-29;1247;1788;3035
2020-04-14;SA;30-39;384;605;989
2020-04-14;CyL;30-39;2232;3290;5522
2020-04-14;AV;40-49;258;368;626
2020-04-14;BU;40-49;552;755;1307
2020-04-14;SA;40-49;498;751;1249
2020-04-14;VA;40-49;665;967;1632
2020-04-14;ZA;40-49;94;148;242
2020-04-14;AV;50-59;236;373;609
2020-04-14;ZA;50-59;101;155;256
2020-04-14;BU;60-69;370;411;781
2020-04-14;LE;60-69;444;533;977
2020-04-14;SE;60-69;330;368;698
2020-04-14;VA;60-69;429;543;972
2020-04-14;ZA;60-69;90;88;178
2020-04-14;PA;70-79;105;98;203
2020-04-14;SA;70-79;308;324;632
2020-04-14;VA;70-79;377;383;760
2020-04-14;SO;>80;159;248;407
2020-04-14;LE;0-9;176;164;340
2020-04-14;PA;0-9;35;18;53
2020-04-14;SA;0-9;191;216;407
2020-04-14;ZA;0-9;116;112;228
2020-04-14;AV;10-19;60;50;110
2020-04-14;BU;10-19;109;111;220
2020-04-14;SO;10-19;24;24;48
2020-04-14;VA;10-19;127;130;257
2020-04-14;AV;20-29;97;131;228
2020-04-14;LE;20-29;175;272;447
2020-04-14;SE;20-29;119;153;272
2020-04-14;AV;30-39;169;252;421
2020-04-14;LE;30-39;321;542;863
2020-04-14;SO;30-39;89;140;229
2020-04-14;SE;40-49;340;439;779
2020-04-14;SO;40-49;160;225;385
2020-04-14;CyL;40-49;3279;4729;8008
2020-04-14;PA;50-59;206;283;489
2020-04-14;SA;50-59;611;931;1542
2020-04-14;SE;50-59;407;552;959
2020-04-14;VA;50-59;570;804;1374
2020-04-14;BU;70-79;251;228;479
2020-04-14;LE;70-79;384;323;707
2020-04-14;SO;70-79;87;66;153
2020-04-14;CyL;70-79;1970;1837;3807
2020-04-14;SA;>80;419;586;1005
2020-04-14;ZA;>80;80;105;185
2020-04-14;CyL;>80;2520;3943;6463
2020-04-13;AV;0-9;84;67;151
2020-04-13;LE;0-9;174;164;338
2020-04-13;CyL;10-19;631;626;1257
2020-04-13;LE;20-29;168;267;435
2020-04-13;PA;20-29;88;99;187
2020-04-13;AV;30-39;167;245;412
2020-04-13;LE;30-39;311;526;837
2020-04-13;PA;30-39;145;181;326
2020-04-13;VA;30-39;447;652;1099
2020-04-13;ZA;30-39;58;104;162
2020-04-13;AV;40-49;252;363;615
2020-04-13;LE;40-49;487;780;1267
2020-04-13;SA;40-49;494;742;1236
2020-04-13;SO;40-49;157;223;380
2020-04-13;ZA;40-49;93;141;234
2020-04-13;AV;50-59;232;362;594
2020-04-13;SO;50-59;173;264;437
2020-04-13;ZA;50-59;98;151;249
2020-04-13;SE;60-69;328;365;693
2020-04-13;VA;60-69;417;536;953
2020-04-13;ZA;60-69;87;86;173
2020-04-13;PA;70-79;102;96;198
2020-04-13;SA;70-79;304;314;618
2020-04-13;SO;70-79;85;64;149
2020-04-13;SE;>80;310;422;732
2020-04-13;VA;>80;413;836;1249
2020-04-13;SE;0-9;75;61;136
2020-04-13;CyL;0-9;1074;960;2034
2020-04-13;LE;10-19;92;102;194
2020-04-13;PA;10-19;46;36;82
2020-04-13;SE;10-19;43;37;80
2020-04-13;VA;10-19;121;128;249
2020-04-13;SA;20-29;210;336;546
2020-04-13;SE;20-29;115;149;264
2020-04-13;SO;20-29;51;75;126
2020-04-13;VA;20-29;247;348;595
2020-04-13;CyL;20-29;1214;1742;2956
2020-04-13;SE;30-39;190;247;437
2020-04-13;BU;40-49;536;734;1270
2020-04-13;CyL;40-49;3207;4628;7835
2020-04-13;BU;50-59;499;687;1186
2020-04-13;LE;50-59;505;728;1233
2020-04-13;CyL;50-59;3269;4716;7985
2020-04-13;AV;60-69;229;257;486
2020-04-13;PA;60-69;164;178;342
2020-04-13;SA;60-69;481;543;1024
2020-04-13;SO;60-69;128;158;286
2020-04-13;AV;70-79;155;164;319
2020-04-13;BU;70-79;241;218;459
2020-04-13;LE;70-79;373;315;688
2020-04-13;ZA;70-79;54;54;108
2020-04-13;CyL;70-79;1926;1787;3713
2020-04-13;AV;>80;224;329;553
2020-04-13;BU;>80;293;421;714
2020-04-13;LE;>80;418;579;997
2020-04-13;PA;>80;124;206;330
2020-04-13;SA;>80;404;564;968
2020-04-13;SO;>80;148;236;384
2020-04-13;BU;0-9;153;117;270
2020-04-13;PA;0-9;35;18;53
2020-04-13;SA;0-9;188;213;401
2020-04-13;SO;0-9;31;22;53
2020-04-13;VA;0-9;220;191;411
2020-04-13;ZA;0-9;114;107;221
2020-04-13;AV;10-19;57;48;105
2020-04-13;BU;10-19;106;105;211
2020-04-13;SA;10-19;113;114;227
2020-04-13;SO;10-19;24;24;48
2020-04-13;ZA;10-19;29;32;61
2020-04-13;AV;20-29;95;131;226
2020-04-13;BU;20-29;208;291;499
2020-04-13;ZA;20-29;32;46;78
2020-04-13;BU;30-39;392;522;914
2020-04-13;SA;30-39;373;594;967
2020-04-13;SO;30-39;84;142;226
2020-04-13;CyL;30-39;2167;3213;5380
2020-04-13;PA;40-49;208;270;478
2020-04-13;SE;40-49;335;434;769
2020-04-13;VA;40-49;645;941;1586
2020-04-13;PA;50-59;199;281;480
2020-04-13;SA;50-59;601;914;1515
2020-04-13;SE;50-59;404;547;951
2020-04-13;VA;50-59;558;782;1340
2020-04-13;BU;60-69;363;399;762
2020-04-13;LE;60-69;437;519;956
2020-04-13;CyL;60-69;2634;3041;5675
2020-04-13;SE;70-79;237;189;426
2020-04-13;VA;70-79;375;373;748
2020-04-13;ZA;>80;73;93;166
2020-04-13;CyL;>80;2407;3686;6093
2020-04-12;BU;0-9;148;116;264
2020-04-12;SO;0-9;29;22;51
2020-04-12;CyL;0-9;1031;935;1966
2020-04-12;BU;10-19;105;104;209
2020-04-12;SO;10-19;22;22;44
2020-04-12;ZA;10-19;28;32;60
2020-04-12;CyL;10-19;602;601;1203
2020-04-12;SO;20-29;49;74;123
2020-04-12;VA;20-29;239;331;570
2020-04-12;CyL;20-29;1182;1695;2877
2020-04-12;AV;30-39;162;241;403
2020-04-12;BU;30-39;389;512;901
2020-04-12;LE;30-39;301;511;812
2020-04-12;PA;30-39;141;179;320
2020-04-12;SA;30-39;364;579;943
2020-04-12;SE;30-39;189;242;431
2020-04-12;BU;40-49;511;718;1229
2020-04-12;CyL;40-49;3096;4508;7604
2020-04-12;PA;50-59;195;273;468
2020-04-12;SA;50-59;588;888;1476
2020-04-12;SO;50-59;167;257;424
2020-04-12;AV;60-69;225;252;477
2020-04-12;SA;60-69;469;522;991
2020-04-12;SO;60-69;126;157;283
2020-04-12;CyL;60-69;2565;2954;5519
2020-04-12;SA;70-79;298;305;603
2020-04-12;ZA;70-79;53;53;106
2020-04-12;CyL;70-79;1865;1724;3589
2020-04-12;AV;>80;212;305;517
2020-04-12;LE;>80;412;554;966
2020-04-12;SA;>80;383;523;906
2020-04-12;ZA;>80;67;84;151
2020-04-12;CyL;>80;2243;3293;5536
2020-04-12;LE;0-9;170;159;329
2020-04-12;AV;10-19;55;47;102
2020-04-12;PA;10-19;44;34;78
2020-04-12;SA;10-19;110;110;220
2020-04-12;SE;10-19;40;35;75
2020-04-12;VA;10-19;111;119;230
2020-04-12;AV;20-29;93;130;223
2020-04-12;LE;20-29;165;261;426
2020-04-12;PA;20-29;86;94;180
2020-04-12;ZA;20-29;30;46;76
2020-04-12;ZA;30-39;55;103;158
2020-04-12;AV;40-49;244;357;601
2020-04-12;LE;40-49;470;756;1226
2020-04-12;SA;40-49;479;727;1206
2020-04-12;SE;40-49;329;423;752
2020-04-12;ZA;40-49;88;135;223
2020-04-12;BU;50-59;482;680;1162
2020-04-12;LE;50-59;497;702;1199
2020-04-12;SE;50-59;391;542;933
2020-04-12;CyL;50-59;3170;4581;7751
2020-04-12;PA;60-69;162;172;334
2020-04-12;SE;60-69;322;356;678
2020-04-12;ZA;60-69;85;86;171
2020-04-12;LE;70-79;368;308;676
2020-04-12;PA;70-79;99;94;193
2020-04-12;SE;70-79;233;184;417
2020-04-12;SO;70-79;82;62;144
2020-04-12;PA;>80;115;179;294
2020-04-12;SE;>80;292;397;689
2020-04-12;SO;>80;141;225;366
2020-04-12;VA;>80;328;633;961
2020-04-12;AV;0-9;79;65;144
2020-04-12;PA;0-9;35;17;52
2020-04-12;SA;0-9;177;206;383
2020-04-12;SE;0-9;73;61;134
2020-04-12;VA;0-9;208;186;394
2020-04-12;ZA;0-9;112;103;215
2020-04-12;LE;10-19;87;98;185
2020-04-12;BU;20-29;203;293;496
2020-04-12;SA;20-29;205;320;525
2020-04-12;SE;20-29;112;146;258
2020-04-12;SO;30-39;80;134;214
2020-04-12;VA;30-39;429;635;1064
2020-04-12;CyL;30-39;2110;3136;5246
2020-04-12;PA;40-49;203;260;463
2020-04-12;SO;40-49;153;220;373
2020-04-12;VA;40-49;619;912;1531
2020-04-12;AV;50-59;224;354;578
2020-04-12;VA;50-59;531;739;1270
2020-04-12;ZA;50-59;95;146;241
2020-04-12;BU;60-69;356;392;748
2020-04-12;LE;60-69;428;505;933
2020-04-12;VA;60-69;392;512;904
2020-04-12;AV;70-79;154;152;306
2020-04-12;BU;70-79;235;218;453
2020-04-12;VA;70-79;343;348;691
2020-04-12;BU;>80;293;393;686
2020-04-11;BU;0-9;148;116;264
2020-04-11;PA;0-9;35;17;52
2020-04-11;SA;0-9;177;206;383
2020-04-11;SO;0-9;29;22;51
2020-04-11;VA;0-9;204;186;390
2020-04-11;CyL;0-9;1027;935;1962
2020-04-11;AV;10-19;55;47;102
2020-04-11;SA;10-19;110;109;219
2020-04-11;VA;10-19;110;117;227
2020-04-11;ZA;10-19;28;32;60
2020-04-11;LE;20-29;164;259;423
2020-04-11;PA;20-29;84;94;178
2020-04-11;SA;20-29;205;319;524
2020-04-11;SE;20-29;112;151;263
2020-04-11;CyL;20-29;1177;1687;2864
2020-04-11;LE;30-39;300;511;811
2020-04-11;PA;30-39;140;176;316
2020-04-11;SE;30-39;187;245;432
2020-04-11;VA;30-39;430;631;1061
2020-04-11;ZA;30-39;55;103;158
2020-04-11;LE;40-49;469;755;1224
2020-04-11;SE;40-49;326;423;749
2020-04-11;CyL;40-49;3082;4496;7578
2020-04-11;BU;50-59;479;678;1157
2020-04-11;SO;50-59;168;251;419
2020-04-11;VA;50-59;530;735;1265
2020-04-11;CyL;50-59;3156;4553;7709
2020-04-11;BU;60-69;354;392;746
2020-04-11;LE;60-69;425;503;928
2020-04-11;BU;70-79;234;216;450
2020-04-11;SE;70-79;234;182;416
2020-04-11;ZA;70-79;53;52;105
2020-04-11;PA;>80;115;175;290
2020-04-11;SA;>80;374;496;870
2020-04-11;SE;>80;296;391;687
2020-04-11;CyL;>80;2207;3171;5378
2020-04-11;LE;0-9;170;159;329
2020-04-11;SE;0-9;73;61;134
2020-04-11;BU;10-19;103;102;205
2020-04-11;LE;10-19;87;97;184
2020-04-11;SE;10-19;40;35;75
2020-04-11;CyL;10-19;599;595;1194
2020-04-11;AV;20-29;94;126;220
2020-04-11;BU;20-29;202;293;495
2020-04-11;SO;20-29;50;74;124
2020-04-11;BU;30-39;386;511;897
2020-04-11;BU;40-49;512;718;1230
2020-04-11;SO;40-49;153;218;371
2020-04-11;VA;40-49;616;908;1524
2020-04-11;LE;50-59;497;704;1201
2020-04-11;PA;50-59;194;270;464
2020-04-11;SA;60-69;463;520;983
2020-04-11;SE;60-69;320;357;677
2020-04-11;SO;60-69;126;158;284
2020-04-11;SA;70-79;296;301;597
2020-04-11;VA;70-79;337;342;679
2020-04-11;CyL;70-79;1847;1704;3551
2020-04-11;BU;>80;292;383;675
2020-04-11;SO;>80;138;220;358
2020-04-11;AV;0-9;79;65;144
2020-04-11;ZA;0-9;112;103;215
2020-04-11;PA;10-19;44;34;78
2020-04-11;SO;10-19;22;22;44
2020-04-11;VA;20-29;236;325;561
2020-04-11;ZA;20-29;30;46;76
2020-04-11;AV;30-39;162;238;400
2020-04-11;SA;30-39;361;575;936
2020-04-11;SO;30-39;78;133;211
2020-04-11;CyL;30-39;2099;3123;5222
2020-04-11;AV;40-49;242;356;598
2020-04-11;PA;40-49;199;259;458
2020-04-11;SA;40-49;477;723;1200
2020-04-11;ZA;40-49;88;136;224
2020-04-11;AV;50-59;222;351;573
2020-04-11;SA;50-59;584;883;1467
2020-04-11;SE;50-59;387;535;922
2020-04-11;ZA;50-59;95;146;241
2020-04-11;AV;60-69;224;248;472
2020-04-11;PA;60-69;159;171;330
2020-04-11;VA;60-69;389;507;896
2020-04-11;ZA;60-69;84;86;170
2020-04-11;CyL;60-69;2544;2942;5486
2020-04-11;AV;70-79;152;152;304
2020-04-11;LE;70-79;363;306;669
2020-04-11;PA;70-79;98;94;192
2020-04-11;SO;70-79;80;59;139
2020-04-11;AV;>80;209;299;508
2020-04-11;LE;>80;400;534;934
2020-04-11;VA;>80;317;590;907
2020-04-11;ZA;>80;66;83;149
2020-04-10;BU;0-9;145;115;260
2020-04-10;LE;0-9;168;159;327
2020-04-10;SE;0-9;73;61;134
2020-04-10;SO;0-9;29;22;51
2020-04-10;AV;10-19;55;47;102
2020-04-10;BU;10-19;102;101;203
2020-04-10;PA;10-19;42;32;74
2020-04-10;SE;10-19;40;35;75
2020-04-10;ZA;10-19;28;32;60
2020-04-10;CyL;10-19;593;589;1182
2020-04-10;PA;20-29;84;91;175
2020-04-10;SA;20-29;202;316;518
2020-04-10;SE;20-29;112;147;259
2020-04-10;ZA;20-29;29;46;75
2020-04-10;CyL;20-29;1166;1664;2830
2020-04-10;AV;30-39;160;234;394
2020-04-10;SE;30-39;188;241;429
2020-04-10;ZA;30-39;55;102;157
2020-04-10;CyL;40-49;3059;4454;7513
2020-04-10;AV;50-59;222;350;572
2020-04-10;SE;50-59;385;528;913
2020-04-10;VA;50-59;526;726;1252
2020-04-10;SE;60-69;321;355;676
2020-04-10;SO;60-69;124;156;280
2020-04-10;VA;60-69;386;506;892
2020-04-10;ZA;60-69;83;86;169
2020-04-10;LE;70-79;364;308;672
2020-04-10;PA;70-79;96;94;190
2020-04-10;ZA;70-79;52;51;103
2020-04-10;CyL;70-79;1828;1689;3517
2020-04-10;BU;>80;285;366;651
2020-04-10;ZA;>80;65;81;146
2020-04-10;AV;0-9;78;65;143
2020-04-10;PA;0-9;34;17;51
2020-04-10;CyL;0-9;1019;934;1953
2020-04-10;LE;10-19;87;97;184
2020-04-10;SO;10-19;22;21;43
2020-04-10;VA;10-19;109;116;225
2020-04-10;AV;20-29;92;123;215
2020-04-10;SO;20-29;50;73;123
2020-04-10;VA;20-29;233;317;550
2020-04-10;LE;30-39;300;509;809
2020-04-10;PA;30-39;141;174;315
2020-04-10;SA;30-39;359;574;933
2020-04-10;VA;30-39;425;626;1051
2020-04-10;AV;40-49;241;353;594
2020-04-10;BU;40-49;504;706;1210
2020-04-10;LE;40-49;466;751;1217
2020-04-10;PA;40-49;197;255;452
2020-04-10;SA;40-49;477;723;1200
2020-04-10;SE;40-49;326;420;746
2020-04-10;BU;50-59;479;670;1149
2020-04-10;SO;50-59;168;250;418
2020-04-10;ZA;50-59;95;145;240
2020-04-10;CyL;50-59;3140;4515;7655
2020-04-10;AV;60-69;221;245;466
2020-04-10;PA;60-69;157;168;325
2020-04-10;CyL;60-69;2524;2919;5443
2020-04-10;AV;70-79;151;151;302
2020-04-10;BU;70-79;233;210;443
2020-04-10;SA;70-79;292;296;588
2020-04-10;SE;70-79;230;180;410
2020-04-10;SO;70-79;79;58;137
2020-04-10;VA;70-79;331;341;672
2020-04-10;LE;>80;398;525;923
2020-04-10;SO;>80;133;218;351
2020-04-10;VA;>80;303;563;866
2020-04-10;CyL;>80;2161;3098;5259
2020-04-10;SA;0-9;177;206;383
2020-04-10;VA;0-9;203;186;389
2020-04-10;ZA;0-9;112;103;215
2020-04-10;SA;10-19;108;108;216
2020-04-10;BU;20-29;202;292;494
2020-04-10;LE;20-29;162;259;421
2020-04-10;BU;30-39;383;507;890
2020-04-10;SO;30-39;77;133;210
2020-04-10;CyL;30-39;2088;3100;5188
2020-04-10;SO;40-49;153;217;370
2020-04-10;VA;40-49;607;893;1500
2020-04-10;ZA;40-49;88;136;224
2020-04-10;LE;50-59;495;704;1199
2020-04-10;PA;50-59;189;267;456
2020-04-10;SA;50-59;581;875;1456
2020-04-10;BU;60-69;352;387;739
2020-04-10;LE;60-69;420;498;918
2020-04-10;SA;60-69;460;518;978
2020-04-10;AV;>80;204;294;498
2020-04-10;PA;>80;113;171;284
2020-04-10;SA;>80;366;489;855
2020-04-10;SE;>80;294;391;685
2020-04-09;AV;0-9;77;64;141
2020-04-09;BU;0-9;140;112;252
2020-04-09;SA;0-9;176;202;378
2020-04-09;SE;0-9;72;61;133
2020-04-09;CyL;0-9;990;917;1907
2020-04-09;PA;10-19;40;29;69
2020-04-09;SE;10-19;39;34;73
2020-04-09;CyL;10-19;572;572;1144
2020-04-09;AV;20-29;88;123;211
2020-04-09;BU;20-29;196;285;481
2020-04-09;CyL;20-29;1142;1620;2762
2020-04-09;PA;30-39;139;166;305
2020-04-09;SO;30-39;78;134;212
2020-04-09;ZA;30-39;55;102;157
2020-04-09;AV;40-49;240;353;593
2020-04-09;BU;40-49;497;697;1194
2020-04-09;SO;40-49;150;211;361
2020-04-09;VA;40-49;598;872;1470
2020-04-09;ZA;40-49;86;132;218
2020-04-09;SA;50-59;570;852;1422
2020-04-09;SE;50-59;375;521;896
2020-04-09;VA;50-59;510;707;1217
2020-04-09;VA;60-69;385;492;877
2020-04-09;LE;70-79;358;301;659
2020-04-09;ZA;70-79;50;49;99
2020-04-09;VA;>80;295;540;835
2020-04-09;ZA;>80;61;71;132
2020-04-09;CyL;>80;2081;2921;5002
2020-04-09;LE;0-9;167;159;326
2020-04-09;PA;0-9;30;17;47
2020-04-09;VA;0-9;189;177;366
2020-04-09;AV;10-19;54;44;98
2020-04-09;BU;10-19;94;98;192
2020-04-09;VA;10-19;105;115;220
2020-04-09;ZA;10-19;26;32;58
2020-04-09;LE;20-29;160;252;412
2020-04-09;PA;20-29;84;89;173
2020-04-09;SA;20-29;199;304;503
2020-04-09;SO;20-29;49;70;119
2020-04-09;VA;20-29;230;308;538
2020-04-09;LE;30-39;292;497;789
2020-04-09;SE;30-39;185;240;425
2020-04-09;VA;30-39;422;611;1033
2020-04-09;CyL;30-39;2062;3037;5099
2020-04-09;LE;40-49;460;737;1197
2020-04-09;SE;40-49;319;413;732
2020-04-09;SO;50-59;167;246;413
2020-04-09;ZA;50-59;96;140;236
2020-04-09;LE;60-69;415;478;893
2020-04-09;PA;60-69;152;164;316
2020-04-09;SA;60-69;451;511;962
2020-04-09;SE;60-69;319;352;671
2020-04-09;SO;60-69;122;153;275
2020-04-09;ZA;60-69;80;86;166
2020-04-09;PA;70-79;89;90;179
2020-04-09;SO;70-79;77;55;132
2020-04-09;BU;>80;273;328;601
2020-04-09;PA;>80;110;169;279
2020-04-09;SA;>80;355;475;830
2020-04-09;SO;0-9;29;22;51
2020-04-09;ZA;0-9;110;103;213
2020-04-09;LE;10-19;86;96;182
2020-04-09;SA;10-19;106;105;211
2020-04-09;SO;10-19;22;19;41
2020-04-09;SE;20-29;107;144;251
2020-04-09;ZA;20-29;29;45;74
2020-04-09;AV;30-39;158;229;387
2020-04-09;BU;30-39;378;496;874
2020-04-09;SA;30-39;355;562;917
2020-04-09;PA;40-49;191;250;441
2020-04-09;SA;40-49;462;704;1166
2020-04-09;CyL;40-49;3003;4369;7372
2020-04-09;AV;50-59;217;339;556
2020-04-09;BU;50-59;470;659;1129
2020-04-09;LE;50-59;483;677;1160
2020-04-09;PA;50-59;181;260;441
2020-04-09;CyL;50-59;3069;4401;7470
2020-04-09;AV;60-69;217;244;461
2020-04-09;BU;60-69;348;377;725
2020-04-09;CyL;60-69;2489;2857;5346
2020-04-09;AV;70-79;148;146;294
2020-04-09;BU;70-79;226;201;427
2020-04-09;SA;70-79;289;290;579
2020-04-09;SE;70-79;228;176;404
2020-04-09;VA;70-79;323;330;653
2020-04-09;CyL;70-79;1788;1638;3426
2020-04-09;AV;>80;193;253;446
2020-04-09;LE;>80;381;508;889
2020-04-09;SE;>80;288;380;668
2020-04-09;SO;>80;125;197;322
2020-04-08;AV;0-9;75;61;136
2020-04-08;BU;0-9;136;111;247
2020-04-08;SO;0-9;28;22;50
2020-04-08;SO;10-19;20;18;38
2020-04-08;AV;20-29;87;120;207
2020-04-08;BU;20-29;189;278;467
2020-04-08;LE;20-29;156;248;404
2020-04-08;SA;20-29;197;300;497
2020-04-08;SO;20-29;46;67;113
2020-04-08;ZA;20-29;29;44;73
2020-04-08;SA;30-39;349;557;906
2020-04-08;ZA;30-39;54;101;155
2020-04-08;BU;40-49;493;681;1174
2020-04-08;SE;40-49;315;406;721
2020-04-08;ZA;40-49;84;127;211
2020-04-08;BU;50-59;463;642;1105
2020-04-08;SA;50-59;562;842;1404
2020-04-08;SE;50-59;374;514;888
2020-04-08;BU;60-69;346;371;717
2020-04-08;LE;60-69;406;466;872
2020-04-08;SA;60-69;448;504;952
2020-04-08;SE;60-69;315;349;664
2020-04-08;ZA;60-69;80;85;165
2020-04-08;CyL;60-69;2451;2802;5253
2020-04-08;SO;70-79;72;50;122
2020-04-08;VA;70-79;315;313;628
2020-04-08;ZA;70-79;49;46;95
2020-04-08;PA;>80;105;162;267
2020-04-08;ZA;>80;54;54;108
2020-04-08;CyL;>80;1993;2766;4759
2020-04-08;LE;0-9;163;156;319
2020-04-08;SA;0-9;176;201;377
2020-04-08;ZA;0-9;108;101;209
2020-04-08;CyL;0-9;970;901;1871
2020-04-08;BU;10-19;92;98;190
2020-04-08;PA;10-19;40;26;66
2020-04-08;VA;10-19;104;109;213
2020-04-08;ZA;10-19;25;32;57
2020-04-08;CyL;10-19;558;549;1107
2020-04-08;SE;20-29;105;143;248
2020-04-08;VA;20-29;227;302;529
2020-04-08;CyL;20-29;1120;1589;2709
2020-04-08;BU;30-39;370;492;862
2020-04-08;LE;30-39;294;482;776
2020-04-08;PA;30-39;138;164;302
2020-04-08;SO;30-39;76;130;206
2020-04-08;CyL;30-39;2036;2980;5016
2020-04-08;AV;40-49;238;342;580
2020-04-08;LE;40-49;448;710;1158
2020-04-08;PA;40-49;184;240;424
2020-04-08;VA;40-49;587;853;1440
2020-04-08;CyL;40-49;2948;4253;7201
2020-04-08;AV;50-59;211;332;543
2020-04-08;LE;50-59;470;653;1123
2020-04-08;PA;50-59;178;256;434
2020-04-08;ZA;50-59;94;136;230
2020-04-08;AV;60-69;211;239;450
2020-04-08;PA;60-69;145;162;307
2020-04-08;AV;70-79;144;142;286
2020-04-08;BU;70-79;218;190;408
2020-04-08;SA;70-79;283;283;566
2020-04-08;SE;70-79;222;173;395
2020-04-08;LE;>80;372;489;861
2020-04-08;SA;>80;341;446;787
2020-04-08;SE;>80;282;373;655
2020-04-08;VA;>80;279;516;795
2020-04-08;PA;0-9;28;16;44
2020-04-08;SE;0-9;72;59;131
2020-04-08;VA;0-9;184;174;358
2020-04-08;AV;10-19;52;41;93
2020-04-08;LE;10-19;83;91;174
2020-04-08;SA;10-19;104;102;206
2020-04-08;SE;10-19;38;32;70
2020-04-08;PA;20-29;84;87;171
2020-04-08;AV;30-39;157;223;380
2020-04-08;SE;30-39;180;235;415
2020-04-08;VA;30-39;418;596;1014
2020-04-08;SA;40-49;452;696;1148
2020-04-08;SO;40-49;147;198;345
2020-04-08;SO;50-59;162;238;400
2020-04-08;VA;50-59;502;691;1193
2020-04-08;CyL;50-59;3016;4304;7320
2020-04-08;SO;60-69;122;146;268
2020-04-08;VA;60-69;378;480;858
2020-04-08;LE;70-79;351;294;645
2020-04-08;PA;70-79;84;89;173
2020-04-08;CyL;70-79;1738;1580;3318
2020-04-08;AV;>80;184;237;421
2020-04-08;BU;>80;262;304;566
2020-04-08;SO;>80;114;185;299
2020-04-07;AV;0-9;74;59;133
2020-04-07;PA;0-9;26;15;41
2020-04-07;SE;0-9;70;59;129
2020-04-07;VA;0-9;176;165;341
2020-04-07;LE;10-19;78;89;167
2020-04-07;SA;10-19;100;100;200
2020-04-07;SO;10-19;19;18;37
2020-04-07;BU;20-29;184;265;449
2020-04-07;SO;20-29;46;65;111
2020-04-07;CyL;20-29;1084;1533;2617
2020-04-07;VA;30-39;403;569;972
2020-04-07;CyL;30-39;1983;2885;4868
2020-04-07;BU;40-49;487;666;1153
2020-04-07;PA;40-49;182;235;417
2020-04-07;VA;40-49;567;818;1385
2020-04-07;AV;50-59;208;325;533
2020-04-07;BU;60-69;338;355;693
2020-04-07;PA;60-69;145;155;300
2020-04-07;VA;60-69;371;460;831
2020-04-07;ZA;60-69;77;83;160
2020-04-07;CyL;60-69;2402;2717;5119
2020-04-07;SE;70-79;215;168;383
2020-04-07;SO;70-79;67;48;115
2020-04-07;BU;>80;252;289;541
2020-04-07;PA;>80;96;145;241
2020-04-07;VA;>80;266;388;654
2020-04-07;SA;0-9;172;196;368
2020-04-07;SO;0-9;27;21;48
2020-04-07;AV;10-19;52;40;92
2020-04-07;PA;10-19;40;25;65
2020-04-07;SE;10-19;37;32;69
2020-04-07;LE;20-29;155;242;397
2020-04-07;SE;20-29;97;137;234
2020-04-07;AV;30-39;148;220;368
2020-04-07;BU;30-39;363;478;841
2020-04-07;LE;30-39;280;466;746
2020-04-07;PA;30-39;136;156;292
2020-04-07;SO;30-39;76;128;204
2020-04-07;ZA;30-39;52;97;149
2020-04-07;LE;40-49;437;700;1137
2020-04-07;SA;40-49;441;669;1110
2020-04-07;SE;40-49;306;397;703
2020-04-07;SO;40-49;146;195;341
2020-04-07;ZA;40-49;81;125;206
2020-04-07;CyL;40-49;2879;4135;7014
2020-04-07;LE;50-59;448;632;1080
2020-04-07;SA;50-59;550;825;1375
2020-04-07;SE;50-59;363;502;865
2020-04-07;SE;60-69;306;337;643
2020-04-07;SO;60-69;118;139;257
2020-04-07;PA;70-79;75;83;158
2020-04-07;SA;70-79;275;278;553
2020-04-07;AV;>80;170;227;397
2020-04-07;SE;>80;279;354;633
2020-04-07;BU;0-9;135;109;244
2020-04-07;LE;0-9;161;151;312
2020-04-07;ZA;0-9;108;98;206
2020-04-07;CyL;0-9;949;873;1822
2020-04-07;BU;10-19;91;92;183
2020-04-07;VA;10-19;102;103;205
2020-04-07;ZA;10-19;24;31;55
2020-04-07;CyL;10-19;543;530;1073
2020-04-07;AV;20-29;83;111;194
2020-04-07;PA;20-29;82;87;169
2020-04-07;SA;20-29;192;293;485
2020-04-07;VA;20-29;216;290;506
2020-04-07;ZA;20-29;29;43;72
2020-04-07;SA;30-39;349;542;891
2020-04-07;SE;30-39;176;229;405
2020-04-07;AV;40-49;232;330;562
2020-04-07;BU;50-59;454;624;1078
2020-04-07;PA;50-59;176;248;424
2020-04-07;SO;50-59;156;234;390
2020-04-07;VA;50-59;491;655;1146
2020-04-07;ZA;50-59;91;134;225
2020-04-07;CyL;50-59;2937;4179;7116
2020-04-07;AV;60-69;208;239;447
2020-04-07;LE;60-69;395;454;849
2020-04-07;SA;60-69;444;495;939
2020-04-07;AV;70-79;142;136;278
2020-04-07;BU;70-79;214;183;397
2020-04-07;LE;70-79;336;289;625
2020-04-07;VA;70-79;306;298;604
2020-04-07;ZA;70-79;47;44;91
2020-04-07;CyL;70-79;1677;1527;3204
2020-04-07;LE;>80;354;434;788
2020-04-07;SA;>80;328;434;762
2020-04-07;SO;>80;102;159;261
2020-04-07;ZA;>80;51;47;98
2020-04-07;CyL;>80;1898;2477;4375
2020-04-06;BU;0-9;131;106;237
2020-04-06;LE;0-9;157;149;306
2020-04-06;SE;0-9;68;58;126
2020-04-06;PA;10-19;39;25;64
2020-04-06;SA;10-19;98;96;194
2020-04-06;SO;10-19;17;18;35
2020-04-06;VA;10-19;94;95;189
2020-04-06;AV;20-29;80;110;190
2020-04-06;LE;20-29;149;231;380
2020-04-06;VA;20-29;206;278;484
2020-04-06;CyL;20-29;1040;1481;2521
2020-04-06;BU;30-39;360;471;831
2020-04-06;SE;30-39;173;221;394
2020-04-06;CyL;30-39;1934;2793;4727
2020-04-06;BU;40-49;477;644;1121
2020-04-06;LE;40-49;423;671;1094
2020-04-06;SE;40-49;299;386;685
2020-04-06;VA;40-49;550;786;1336
2020-04-06;CyL;40-49;2799;4004;6803
2020-04-06;SE;50-59;351;496;847
2020-04-06;VA;50-59;470;624;1094
2020-04-06;AV;60-69;203;232;435
2020-04-06;SA;60-69;433;488;921
2020-04-06;VA;60-69;358;443;801
2020-04-06;CyL;60-69;2329;2635;4964
2020-04-06;BU;70-79;209;177;386
2020-04-06;PA;70-79;71;79;150
2020-04-06;SE;70-79;212;162;374
2020-04-06;CyL;70-79;1645;1483;3128
2020-04-06;AV;>80;160;214;374
2020-04-06;BU;>80;244;279;523
2020-04-06;SA;>80;315;414;729
2020-04-06;VA;>80;255;377;632
2020-04-06;CyL;>80;1827;2347;4174
2020-04-06;PA;0-9;24;16;40
2020-04-06;SA;0-9;169;192;361
2020-04-06;VA;0-9;168;161;329
2020-04-06;LE;10-19;77;84;161
2020-04-06;CyL;10-19;524;502;1026
2020-04-06;PA;20-29;81;86;167
2020-04-06;SO;20-29;44;60;104
2020-04-06;AV;30-39;145;212;357
2020-04-06;PA;30-39;132;153;285
2020-04-06;SA;30-39;338;528;866
2020-04-06;SO;30-39;71;119;190
2020-04-06;ZA;30-39;49;92;141
2020-04-06;SO;50-59;151;230;381
2020-04-06;CyL;50-59;2836;4053;6889
2020-04-06;LE;60-69;375;446;821
2020-04-06;AV;0-9;73;60;133
2020-04-06;SO;0-9;26;20;46
2020-04-06;ZA;0-9;106;91;197
2020-04-06;CyL;0-9;922;853;1775
2020-04-06;AV;10-19;50;39;89
2020-04-06;BU;10-19;90;84;174
2020-04-06;SE;10-19;37;32;69
2020-04-06;ZA;10-19;22;29;51
2020-04-06;BU;20-29;175;258;433
2020-04-06;SA;20-29;183;287;470
2020-04-06;SE;20-29;94;132;226
2020-04-06;ZA;20-29;28;39;67
2020-04-06;LE;30-39;277;456;733
2020-04-06;VA;30-39;389;541;930
2020-04-06;AV;40-49;222;325;547
2020-04-06;PA;40-49;176;233;409
2020-04-06;SA;40-49;433;652;1085
2020-04-06;SO;40-49;142;190;332
2020-04-06;ZA;40-49;77;117;194
2020-04-06;AV;50-59;198;321;519
2020-04-06;BU;50-59;436;610;1046
2020-04-06;LE;50-59;435;612;1047
2020-04-06;PA;50-59;172;235;407
2020-04-06;SA;50-59;537;796;1333
2020-04-06;ZA;50-59;86;129;215
2020-04-06;BU;60-69;332;338;670
2020-04-06;PA;60-69;140;150;290
2020-04-06;SE;60-69;302;323;625
2020-04-06;SO;60-69;114;136;250
2020-04-06;ZA;60-69;72;79;151
2020-04-06;AV;70-79;134;131;265
2020-04-06;LE;70-79;331;282;613
2020-04-06;SA;70-79;272;269;541
2020-04-06;SO;70-79;66;45;111
2020-04-06;VA;70-79;304;294;598
2020-04-06;ZA;70-79;46;44;90
2020-04-06;LE;>80;347;407;754
2020-04-06;PA;>80;90;134;224
2020-04-06;SE;>80;269;329;598
2020-04-06;SO;>80;97;147;244
2020-04-06;ZA;>80;50;46;96
2020-04-05;AV;0-9;71;56;127
2020-04-05;BU;0-9;124;104;228
2020-04-05;VA;0-9;163;154;317
2020-04-05;SO;10-19;17;18;35
2020-04-05;VA;10-19;90;92;182
2020-04-05;ZA;10-19;22;27;49
2020-04-05;CyL;10-19;504;481;985
2020-04-05;LE;20-29;147;221;368
2020-04-05;BU;30-39;350;447;797
2020-04-05;SA;30-39;324;513;837
2020-04-05;CyL;30-39;1854;2667;4521
2020-04-05;LE;40-49;398;633;1031
2020-04-05;SA;40-49;418;644;1062
2020-04-05;SE;40-49;289;373;662
2020-04-05;ZA;40-49;74;112;186
2020-04-05;CyL;40-49;2674;3833;6507
2020-04-05;PA;50-59;166;221;387
2020-04-05;SO;50-59;143;221;364
2020-04-05;ZA;50-59;81;124;205
2020-04-05;VA;60-69;341;420;761
2020-04-05;ZA;60-69;69;75;144
2020-04-05;AV;70-79;131;125;256
2020-04-05;LE;70-79;322;274;596
2020-04-05;SO;70-79;64;43;107
2020-04-05;BU;>80;227;267;494
2020-04-05;PA;>80;83;124;207
2020-04-05;SE;>80;258;293;551
2020-04-05;CyL;>80;1696;2122;3818
2020-04-05;PA;0-9;23;16;39
2020-04-05;SA;0-9;163;183;346
2020-04-05;SE;0-9;66;57;123
2020-04-05;AV;10-19;47;35;82
2020-04-05;LE;10-19;71;80;151
2020-04-05;PA;10-19;38;23;61
2020-04-05;AV;20-29;77;103;180
2020-04-05;BU;20-29;165;245;410
2020-04-05;PA;20-29;77;80;157
2020-04-05;SE;20-29;85;125;210
2020-04-05;VA;20-29;191;266;457
2020-04-05;ZA;20-29;26;36;62
2020-04-05;CyL;20-29;984;1405;2389
2020-04-05;AV;30-39;134;199;333
2020-04-05;LE;30-39;266;438;704
2020-04-05;SE;30-39;165;206;371
2020-04-05;SO;30-39;70;118;188
2020-04-05;ZA;30-39;48;90;138
2020-04-05;AV;40-49;214;303;517
2020-04-05;BU;40-49;463;612;1075
2020-04-05;AV;50-59;190;303;493
2020-04-05;BU;50-59;418;584;1002
2020-04-05;LE;50-59;423;583;1006
2020-04-05;SA;50-59;517;762;1279
2020-04-05;SE;50-59;338;480;818
2020-04-05;CyL;50-59;2722;3857;6579
2020-04-05;AV;60-69;198;221;419
2020-04-05;PA;60-69;139;143;282
2020-04-05;SA;60-69;412;464;876
2020-04-05;SE;60-69;297;313;610
2020-04-05;SO;60-69;112;133;245
2020-04-05;CyL;60-69;2254;2520;4774
2020-04-05;PA;70-79;71;75;146
2020-04-05;SE;70-79;206;156;362
2020-04-05;VA;70-79;288;270;558
2020-04-05;ZA;70-79;44;41;85
2020-04-05;LE;>80;336;382;718
2020-04-05;LE;0-9;154;145;299
2020-04-05;SO;0-9;26;20;46
2020-04-05;ZA;0-9;103;89;192
2020-04-05;CyL;0-9;893;824;1717
2020-04-05;BU;10-19;87;79;166
2020-04-05;SA;10-19;96;95;191
2020-04-05;SE;10-19;36;32;68
2020-04-05;SA;20-29;174;269;443
2020-04-05;SO;20-29;42;60;102
2020-04-05;PA;30-39;130;141;271
2020-04-05;VA;30-39;367;515;882
2020-04-05;PA;40-49;166;221;387
2020-04-05;SO;40-49;135;182;317
2020-04-05;VA;40-49;517;753;1270
2020-04-05;VA;50-59;446;579;1025
2020-04-05;BU;60-69;323;326;649
2020-04-05;LE;60-69;363;425;788
2020-04-05;BU;70-79;208;167;375
2020-04-05;SA;70-79;260;261;521
2020-04-05;CyL;70-79;1594;1412;3006
2020-04-05;AV;>80;147;196;343
2020-04-05;SA;>80;288;363;651
2020-04-05;SO;>80;92;142;234
2020-04-05;VA;>80;219;315;534
2020-04-05;ZA;>80;46;40;86
2020-04-04;AV;0-9;71;57;128
2020-04-04;LE;0-9;153;144;297
2020-04-04;PA;0-9;22;15;37
2020-04-04;CyL;0-9;887;824;1711
2020-04-04;PA;10-19;36;22;58
2020-04-04;PA;20-29;77;79;156
2020-04-04;SE;20-29;83;123;206
2020-04-04;ZA;20-29;26;36;62
2020-04-04;BU;30-39;345;441;786
2020-04-04;PA;30-39;127;140;267
2020-04-04;SE;30-39;164;203;367
2020-04-04;AV;40-49;212;297;509
2020-04-04;LE;40-49;397;631;1028
2020-04-04;SA;40-49;413;637;1050
2020-04-04;VA;40-49;510;746;1256
2020-04-04;ZA;40-49;74;112;186
2020-04-04;BU;50-59;413;574;987
2020-04-04;LE;50-59;421;581;1002
2020-04-04;SO;50-59;142;216;358
2020-04-04;AV;60-69;197;216;413
2020-04-04;SO;60-69;108;131;239
2020-04-04;ZA;60-69;68;75;143
2020-04-04;CyL;60-69;2226;2487;4713
2020-04-04;SA;70-79;250;256;506
2020-04-04;SE;70-79;202;155;357
2020-04-04;VA;70-79;285;267;552
2020-04-04;ZA;70-79;43;41;84
2020-04-04;PA;>80;78;115;193
2020-04-04;BU;0-9;123;104;227
2020-04-04;SA;0-9;161;184;345
2020-04-04;VA;0-9;163;154;317
2020-04-04;ZA;0-9;103;89;192
2020-04-04;AV;10-19;47;35;82
2020-04-04;SO;10-19;17;18;35
2020-04-04;ZA;10-19;22;27;49
2020-04-04;BU;20-29;162;242;404
2020-04-04;LE;20-29;147;218;365
2020-04-04;SA;20-29;174;269;443
2020-04-04;SO;20-29;42;59;101
2020-04-04;VA;20-29;190;262;452
2020-04-04;AV;30-39;128;197;325
2020-04-04;LE;30-39;267;432;699
2020-04-04;SA;30-39;324;502;826
2020-04-04;SO;30-39;69;117;186
2020-04-04;VA;30-39;365;514;879
2020-04-04;ZA;30-39;48;90;138
2020-04-04;BU;40-49;460;607;1067
2020-04-04;PA;40-49;165;220;385
2020-04-04;SE;40-49;283;367;650
2020-04-04;CyL;40-49;2648;3795;6443
2020-04-04;SA;50-59;506;747;1253
2020-04-04;SE;50-59;332;470;802
2020-04-04;VA;50-59;445;578;1023
2020-04-04;ZA;50-59;80;122;202
2020-04-04;BU;60-69;317;321;638
2020-04-04;PA;60-69;136;137;273
2020-04-04;SA;60-69;412;461;873
2020-04-04;SE;60-69;291;309;600
2020-04-04;BU;70-79;206;166;372
2020-04-04;SO;70-79;63;43;106
2020-04-04;CyL;70-79;1566;1399;2965
2020-04-04;AV;>80;143;189;332
2020-04-04;BU;>80;222;260;482
2020-04-04;LE;>80;336;378;714
2020-04-04;CyL;>80;1660;2043;3703
2020-04-04;SE;0-9;65;57;122
2020-04-04;SO;0-9;26;20;46
2020-04-04;BU;10-19;85;79;164
2020-04-04;LE;10-19;71;80;151
2020-04-04;SA;10-19;96;95;191
2020-04-04;SE;10-19;36;32;68
2020-04-04;VA;10-19;87;90;177
2020-04-04;CyL;10-19;497;478;975
2020-04-04;AV;20-29;76;102;178
2020-04-04;CyL;20-29;977;1390;2367
2020-04-04;CyL;30-39;1837;2636;4473
2020-04-04;SO;40-49;134;178;312
2020-04-04;AV;50-59;188;298;486
2020-04-04;PA;50-59;166;216;382
2020-04-04;CyL;50-59;2693;3802;6495
2020-04-04;LE;60-69;359;420;779
2020-04-04;VA;60-69;338;417;755
2020-04-04;AV;70-79;130;124;254
2020-04-04;LE;70-79;318;272;590
2020-04-04;PA;70-79;69;75;144
2020-04-04;SA;>80;282;345;627
2020-04-04;SE;>80;250;287;537
2020-04-04;SO;>80;90;136;226
2020-04-04;VA;>80;213;293;506
2020-04-04;ZA;>80;46;40;86
2020-04-03;BU;10-19;84;75;159
2020-04-03;SO;10-19;16;18;34
2020-04-03;CyL;10-19;489;465;954
2020-04-03;SE;20-29;84;122;206
2020-04-03;SO;30-39;67;116;183
2020-04-03;LE;40-49;394;629;1023
2020-04-03;PA;50-59;162;209;371
2020-04-03;SA;50-59;495;739;1234
2020-04-03;SE;50-59;324;468;792
2020-04-03;SO;50-59;139;215;354
2020-04-03;AV;60-69;196;215;411
2020-04-03;SE;60-69;290;307;597
2020-04-03;VA;60-69;336;412;748
2020-04-03;BU;70-79;203;161;364
2020-04-03;SA;70-79;246;254;500
2020-04-03;SO;70-79;61;43;104
2020-04-03;LE;>80;324;375;699
2020-04-03;PA;>80;77;114;191
2020-04-03;SE;>80;242;283;525
2020-04-03;BU;0-9;121;104;225
2020-04-03;LE;0-9;153;144;297
2020-04-03;PA;0-9;22;14;36
2020-04-03;SE;0-9;65;57;122
2020-04-03;VA;0-9;162;155;317
2020-04-03;ZA;0-9;103;89;192
2020-04-03;CyL;0-9;884;824;1708
2020-04-03;AV;10-19;46;35;81
2020-04-03;LE;10-19;71;79;150
2020-04-03;SA;10-19;93;91;184
2020-04-03;ZA;10-19;22;27;49
2020-04-03;BU;20-29;156;240;396
2020-04-03;LE;20-29;144;216;360
2020-04-03;CyL;20-29;962;1380;2342
2020-04-03;AV;30-39;125;196;321
2020-04-03;SA;30-39;321;496;817
2020-04-03;ZA;30-39;48;89;137
2020-04-03;AV;40-49;211;295;506
2020-04-03;BU;40-49;453;598;1051
2020-04-03;SA;40-49;404;630;1034
2020-04-03;SE;40-49;280;362;642
2020-04-03;SO;40-49;131;171;302
2020-04-03;VA;40-49;505;730;1235
2020-04-03;LE;50-59;418;575;993
2020-04-03;VA;50-59;443;570;1013
2020-04-03;CyL;50-59;2656;3755;6411
2020-04-03;LE;60-69;357;414;771
2020-04-03;LE;70-79;317;271;588
2020-04-03;PA;70-79;68;75;143
2020-04-03;CyL;70-79;1547;1371;2918
2020-04-03;AV;>80;137;176;313
2020-04-03;SA;>80;280;341;621
2020-04-03;SO;>80;89;134;223
2020-04-03;VA;>80;208;285;493
2020-04-03;ZA;>80;45;38;83
2020-04-03;CyL;>80;1618;1993;3611
2020-04-03;AV;0-9;71;57;128
2020-04-03;SA;0-9;161;184;345
2020-04-03;SO;0-9;26;20;46
2020-04-03;PA;10-19;36;21;57
2020-04-03;SE;10-19;36;30;66
2020-04-03;VA;10-19;85;89;174
2020-04-03;AV;20-29;75;99;174
2020-04-03;PA;20-29;74;80;154
2020-04-03;SA;20-29;172;266;438
2020-04-03;SO;20-29;42;58;100
2020-04-03;VA;20-29;189;263;452
2020-04-03;ZA;20-29;26;36;62
2020-04-03;BU;30-39;344;439;783
2020-04-03;LE;30-39;264;428;692
2020-04-03;PA;30-39;123;133;256
2020-04-03;SE;30-39;162;202;364
2020-04-03;VA;30-39;354;505;859
2020-04-03;CyL;30-39;1808;2604;4412
2020-04-03;PA;40-49;163;214;377
2020-04-03;ZA;40-49;74;113;187
2020-04-03;CyL;40-49;2615;3742;6357
2020-04-03;AV;50-59;186;292;478
2020-04-03;BU;50-59;409;567;976
2020-04-03;ZA;50-59;80;120;200
2020-04-03;BU;60-69;315;317;632
2020-04-03;PA;60-69;129;135;264
2020-04-03;SA;60-69;407;459;866
2020-04-03;SO;60-69;107;130;237
2020-04-03;ZA;60-69;67;75;142
2020-04-03;CyL;60-69;2204;2464;4668
2020-04-03;AV;70-79;126;119;245
2020-04-03;SE;70-79;199;149;348
2020-04-03;VA;70-79;284;259;543
2020-04-03;ZA;70-79;43;40;83
2020-04-03;BU;>80;216;247;463
